date,field,runs_scored,runs_allowed,opponent,run_difference
2021-02-20,@Abilene Christian,16,3,Tarleton State,13
2021-02-20,@Abilene Christian,7,2,Tarleton State,5
2021-02-21,@Tarleton State,4,10,Tarleton State,-6
2021-02-23,@Texas A&M,6,5,Texas A&M,1
2021-02-26,@Abilene Christian,8,7,New Mexico State,1
2021-02-27,@Abilene Christian,15,9,New Mexico State,6
2021-02-28,@Abilene Christian,2,12,New Mexico State,-10
2021-03-02,@Texas-Arlington,2,3,Texas-Arlington,-1
2021-03-05,@Abilene Christian,26,3,Arkansas State,23
2021-03-06,@Abilene Christian,6,5,Arkansas State,1
2021-03-07,@Abilene Christian,9,4,Arkansas State,5
2021-03-12,@Central Arkansas,9,8,Central Arkansas,1
2021-03-13,@Central Arkansas,5,4,Central Arkansas,1
2021-03-13,@Central Arkansas,3,6,Central Arkansas,-3
2021-03-14,@Central Arkansas,8,9,Central Arkansas,-1
2021-03-19,@Abilene Christian,6,7,Nicholls State,-1
2021-03-20,@Abilene Christian,6,5,Nicholls State,1
2021-03-20,@Abilene Christian,4,1,Nicholls State,3
2021-03-21,@Abilene Christian,4,7,Nicholls State,-3
2021-03-26,@New Orleans,9,6,New Orleans,3
2021-03-27,@New Orleans,19,10,New Orleans,9
2021-03-27,@New Orleans,4,8,New Orleans,-4
2021-03-28,@New Orleans,16,12,New Orleans,4
2021-04-01,@Abilene Christian,2,8,Northwestern State,-6
2021-04-02,@Abilene Christian,11,0,Northwestern State,11
2021-04-02,@Abilene Christian,3,5,Northwestern State,-2
2021-04-03,@Abilene Christian,5,6,Northwestern State,-1
2021-04-09,@Southeastern Louisiana,13,9,Southeastern Louisiana,4
2021-04-10,@Southeastern Louisiana,8,4,Southeastern Louisiana,4
2021-04-10,@Southeastern Louisiana,3,8,Southeastern Louisiana,-5
2021-04-11,@Southeastern Louisiana,0,7,Southeastern Louisiana,-7
2021-04-13,@Abilene Christian,11,10,Texas-Arlington,1
2021-04-16,@Texas,0,18,Texas,-18
2021-04-17,@Texas,1,3,Texas,-2
2021-04-18,@Texas,1,11,Texas,-10
2021-04-23,@Abilene Christian,1,12,Incarnate Word,-11
2021-04-24,@Abilene Christian,8,3,Incarnate Word,5
2021-04-24,@Abilene Christian,10,7,Incarnate Word,3
2021-04-25,@Abilene Christian,8,4,Incarnate Word,4
2021-05-02,@Houston Baptist,5,2,Houston Baptist,3
2021-05-02,@Houston Baptist,8,6,Houston Baptist,2
2021-05-07,@Abilene Christian,3,2,Lamar,1
2021-05-08,@Abilene Christian,8,4,Lamar,4
2021-05-08,@Abilene Christian,10,5,Lamar,5
2021-05-09,@Abilene Christian,7,5,Lamar,2
2021-05-14,@Sam Houston State,10,1,Sam Houston State,9
2021-05-15,@Sam Houston State,12,6,Sam Houston State,6
2021-05-15,@Sam Houston State,4,5,Sam Houston State,-1
2021-05-16,@Sam Houston State,5,3,Sam Houston State,2
2021-05-20,@Abilene Christian,13,3,Stephen F. Austin State,10
2021-05-21,@Abilene Christian,7,3,Stephen F. Austin State,4
2021-05-21,@Abilene Christian,6,4,Stephen F. Austin State,2
2021-05-22,@Abilene Christian,3,9,Stephen F. Austin State,-6
2021-05-26,@Abilene Christian,7,1,Lamar,6
2021-05-27,@Abilene Christian,4,3,Texas A&M-Corpus Christi,1
2021-05-28,@Sam Houston State,12,14,Sam Houston State,-2
2021-05-29,@Abilene Christian,13,15,Sam Houston State,-2
2021-02-20,@Louisiana State,1,6,Louisiana State,-5
2021-02-21,@Louisiana State,6,5,Louisiana State,1
2021-02-21,@Air Force,1,18,Louisiana Tech,-17
2021-02-27,@New Mexico,2,5,New Mexico,-3
2021-02-27,@New Mexico,7,11,New Mexico,-4
2021-02-28,@New Mexico,4,11,New Mexico,-7
2021-03-05,@Air Force,4,1,Army,3
2021-03-06,@Army,12,1,Army,11
2021-03-07,@Air Force,5,4,Army,1
2021-03-13,@Air Force,12,3,Wichita State,9
2021-03-13,@Arizona,5,2,Arizona,3
2021-03-14,@Arizona,5,14,Arizona,-9
2021-03-20,@San Diego State,1,5,San Diego State,-4
2021-03-20,@San Diego State,2,9,San Diego State,-7
2021-03-21,@San Diego State,13,9,San Diego State,4
2021-03-27,@Air Force,4,3,Nevada-Las Vegas,1
2021-03-27,@Air Force,10,7,Nevada-Las Vegas,3
2021-03-28,@Air Force,11,10,Nevada-Las Vegas,1
2021-04-02,@Nevada,7,5,Nevada,2
2021-04-02,@Nevada,2,1,Nevada,1
2021-04-03,@Nevada,9,15,Nevada,-6
2021-04-10,@Fresno State,3,8,Fresno State,-5
2021-04-10,@Fresno State,1,7,Fresno State,-6
2021-04-11,@Fresno State,12,6,Fresno State,6
2021-04-13,@Kansas,3,13,Kansas,-10
2021-04-14,@Kansas,4,7,Kansas,-3
2021-04-16,@Dallas Baptist,0,2,Dallas Baptist,-2
2021-04-17,@Dallas Baptist,3,0,Dallas Baptist,3
2021-04-18,@Dallas Baptist,5,3,Dallas Baptist,2
2021-04-24,@Air Force,7,14,Nevada,-7
2021-04-24,@Air Force,6,3,Nevada,3
2021-04-25,@Air Force,4,7,Nevada,-3
2021-05-01,@Nevada-Las Vegas,4,11,Nevada-Las Vegas,-7
2021-05-01,@Nevada-Las Vegas,9,12,Nevada-Las Vegas,-3
2021-05-02,@Nevada-Las Vegas,8,6,Nevada-Las Vegas,2
2021-05-08,@Air Force,6,4,New Mexico,2
2021-05-08,@Air Force,15,12,New Mexico,3
2021-05-09,@Air Force,10,3,New Mexico,7
2021-05-14,@Air Force,11,6,San Jose State,5
2021-05-15,@Air Force,9,3,San Jose State,6
2021-05-15,@Air Force,11,3,San Jose State,8
2021-05-16,@Air Force,5,3,San Jose State,2
2021-05-22,@Air Force,3,17,San Diego State,-14
2021-05-23,@Air Force,13,20,San Diego State,-7
2021-05-23,@Air Force,10,13,San Diego State,-3
2021-05-28,@Air Force,13,6,Fresno State,7
2021-05-28,@Air Force,9,7,Fresno State,2
2021-05-29,@Air Force,8,9,Fresno State,-1
2021-03-06,@Akron,13,0,Olivet,13
2021-03-06,@Akron,9,1,Olivet,8
2021-03-10,@Akron,1,5,Wittenberg,-4
2021-03-11,@Akron,16,1,Salem University,15
2021-03-12,@Akron,5,3,Grand Valley,2
2021-03-14,@Akron,12,1,Mercyhurst,11
2021-03-19,@Akron,2,9,Eastern Michigan,-7
2021-03-20,@Akron,3,2,Eastern Michigan,1
2021-03-20,@Akron,8,6,Eastern Michigan,2
2021-03-21,@Akron,6,8,Eastern Michigan,-2
2021-03-24,@Akron,11,9,Shawnee State,2
2021-03-26,@Akron,6,3,Bowling Green State,3
2021-03-27,@Akron,1,7,Bowling Green State,-6
2021-03-27,@Akron,0,6,Bowling Green State,-6
2021-03-28,@Akron,2,3,Bowling Green State,-1
2021-03-30,@Dayton,7,18,Dayton,-11
2021-04-02,@Western Michigan,0,10,Western Michigan,-10
2021-04-03,@Western Michigan,2,13,Western Michigan,-11
2021-04-03,@Western Michigan,6,7,Western Michigan,-1
2021-04-04,@Western Michigan,0,3,Western Michigan,-3
2021-04-07,@Akron,3,9,Walsh University,-6
2021-04-09,@Akron,3,7,Ball State,-4
2021-04-10,@Akron,2,4,Ball State,-2
2021-04-10,@Akron,0,10,Ball State,-10
2021-04-11,@Akron,2,13,Ball State,-11
2021-04-14,@Akron,5,11,Malone,-6
2021-04-16,@Toledo,1,6,Toledo,-5
2021-04-17,@Toledo,0,7,Toledo,-7
2021-04-17,@Toledo,4,12,Toledo,-8
2021-04-18,@Toledo,2,12,Toledo,-10
2021-04-23,@Akron,1,13,Central Michigan,-12
2021-04-24,@Akron,0,12,Central Michigan,-12
2021-04-24,@Akron,2,3,Central Michigan,-1
2021-04-25,@Akron,2,15,Central Michigan,-13
2021-04-30,@Northern Illinois,6,7,Northern Illinois,-1
2021-05-01,@Northern Illinois,2,11,Northern Illinois,-9
2021-05-01,@Northern Illinois,1,3,Northern Illinois,-2
2021-05-02,@Northern Illinois,7,4,Northern Illinois,3
2021-05-07,@Kent State,3,13,Kent State,-10
2021-05-08,@Kent State,2,1,Kent State,1
2021-05-08,@Kent State,2,10,Kent State,-8
2021-05-10,@Kent State,3,8,Kent State,-5
2021-05-14,@Akron,4,2,Ohio,2
2021-05-15,@Akron,3,1,Ohio,2
2021-05-15,@Akron,0,4,Ohio,-4
2021-05-16,@Akron,9,8,Ohio,1
2021-05-21,"@Miami, Ohio",2,3,"Miami, Ohio",-1
2021-05-22,"@Miami, Ohio",2,9,"Miami, Ohio",-7
2021-05-22,"@Miami, Ohio",2,6,"Miami, Ohio",-4
2021-05-23,"@Miami, Ohio",1,6,"Miami, Ohio",-5
2021-05-25,@Kent State,9,6,Kent State,3
2021-02-19,@Alabama,10,6,McNeese State,4
2021-02-20,@Alabama,4,3,McNeese State,1
2021-02-21,@Alabama,9,5,McNeese State,4
2021-02-23,@Jacksonville State,5,2,Jacksonville State,3
2021-02-24,@Alabama,4,9,Tennessee-Martin,-5
2021-02-26,@Alabama,8,4,Wright State,4
2021-02-27,@Alabama,1,0,Wright State,1
2021-02-27,@Alabama,8,7,Wright State,1
2021-03-03,@Alabama,9,1,Troy,8
2021-03-05,@College of Charleston,8,0,College of Charleston,8
2021-03-06,@College of Charleston,0,1,College of Charleston,-1
2021-03-07,@College of Charleston,21,3,College of Charleston,18
2021-03-09,@Alabama,11,8,South Alabama,3
2021-03-10,@Alabama,7,2,Jacksonville State,5
2021-03-12,@Alabama,2,4,Stetson,-2
2021-03-13,@Alabama,4,3,Stetson,1
2021-03-14,@Alabama,9,4,Stetson,5
2021-03-19,@Arkansas,16,1,Arkansas,15
2021-03-20,@Arkansas,1,9,Arkansas,-8
2021-03-21,@Arkansas,1,3,Arkansas,-2
2021-03-23,@Alabama,4,5,Southern Mississippi,-1
2021-03-26,@Alabama,0,2,Mississippi,-2
2021-03-26,@Alabama,6,9,Mississippi,-3
2021-03-27,@Alabama,6,11,Mississippi,-5
2021-04-02,@Alabama,7,4,Tennessee,3
2021-04-03,@Alabama,4,8,Tennessee,-4
2021-04-04,@Alabama,8,9,Tennessee,-1
2021-04-07,@Alabama,3,5,Louisiana-Monroe,-2
2021-04-09,@Texas A&M,5,3,Texas A&M,2
2021-04-10,@Texas A&M,6,3,Texas A&M,3
2021-04-11,@Texas A&M,7,4,Texas A&M,3
2021-04-13,@Alabama,19,3,Samford,16
2021-04-15,@Alabama,8,7,Auburn,1
2021-04-16,@Alabama,4,5,Auburn,-1
2021-04-17,@Alabama,10,9,Auburn,1
2021-04-20,@Alabama,8,6,North Alabama,2
2021-04-23,@Kentucky,10,1,Kentucky,9
2021-04-25,@Kentucky,2,5,Kentucky,-3
2021-04-25,@Kentucky,0,11,Kentucky,-11
2021-04-27,@Alabama-Birmingham,9,3,Alabama-Birmingham,6
2021-04-30,@Alabama,11,8,Missouri,3
2021-05-01,@Alabama,5,2,Missouri,3
2021-05-02,@Alabama,3,2,Missouri,1
2021-05-07,@Vanderbilt,6,9,Vanderbilt,-3
2021-05-08,@Vanderbilt,2,6,Vanderbilt,-4
2021-05-14,@Louisiana State,1,2,Louisiana State,-1
2021-05-15,@Louisiana State,6,5,Louisiana State,1
2021-05-16,@Louisiana State,5,13,Louisiana State,-8
2021-05-20,@Alabama,2,4,Mississippi State,-2
2021-05-21,@Alabama,0,7,Mississippi State,-7
2021-05-22,@Alabama,3,7,Mississippi State,-4
2021-05-25,@South Carolina,9,3,South Carolina,6
2021-05-26,@Tennessee,3,2,Tennessee,1
2021-05-27,@Alabama,2,7,Florida,-5
2021-05-28,@Alabama,0,11,Tennessee,-11
2021-06-04,@North Carolina State,1,8,North Carolina State,-7
2021-06-05,@Alabama,3,1,Rider,2
2021-06-06,@Alabama,8,10,Louisiana Tech,-2
2021-02-23,@Auburn,2,18,Auburn,-16
2021-02-24,@Auburn,0,33,Auburn,-33
2021-02-26,@Alabama-Birmingham,2,22,Alabama-Birmingham,-20
2021-02-27,@Alabama-Birmingham,2,9,Alabama-Birmingham,-7
2021-02-28,@Alabama-Birmingham,3,7,Alabama-Birmingham,-4
2021-03-19,@Alabama A&M,9,2,Alcorn State,7
2021-03-20,@Alabama A&M,14,16,Alcorn State,-2
2021-03-21,@Alabama A&M,0,12,Alcorn State,-12
2021-03-26,@Jackson State,3,14,Jackson State,-11
2021-03-27,@Jackson State,0,16,Jackson State,-16
2021-03-28,@Jackson State,2,6,Jackson State,-4
2021-04-01,@Alabama A&M,10,8,Alabama State,2
2021-04-02,@Alabama A&M,0,15,Alabama State,-15
2021-04-03,@Alabama A&M,1,15,Alabama State,-14
2021-04-16,@Alabama A&M,3,1,Mississippi Valley State,2
2021-04-17,@Alabama A&M,21,6,Mississippi Valley State,15
2021-04-17,@Alabama A&M,10,9,Mississippi Valley State,1
2021-04-18,@Alabama A&M,8,7,Mississippi Valley State,1
2021-04-22,@Alcorn State,12,5,Alcorn State,7
2021-04-23,@Alcorn State,4,3,Alcorn State,1
2021-04-23,@Alcorn State,5,2,Alcorn State,3
2021-04-30,@Alabama A&M,0,13,Jackson State,-13
2021-05-01,@Alabama A&M,3,9,Jackson State,-6
2021-05-02,@Alabama A&M,3,9,Jackson State,-6
2021-05-07,@Alabama State,3,17,Alabama State,-14
2021-05-08,@Alabama State,3,9,Alabama State,-6
2021-05-09,@Alabama State,6,32,Alabama State,-26
2021-05-19,@Grambling State,1,8,Grambling State,-7
2021-05-20,@Alabama A&M,7,12,Texas Southern,-5
2021-02-20,@Tennessee Tech,3,5,Tennessee Tech,-2
2021-02-20,@Jacksonville State,3,5,Jacksonville State,-2
2021-02-21,@Alabama State,1,13,Southern Illinois,-12
2021-02-23,@Samford,11,9,Samford,2
2021-02-27,@Alabama State,1,2,Eastern Michigan,-1
2021-02-28,@Alabama State,3,4,Eastern Michigan,-1
2021-03-05,@Alabama State,7,8,Jackson State,-1
2021-03-06,@Alabama State,2,3,Jackson State,-1
2021-03-07,@Alabama State,3,4,Jackson State,-1
2021-03-10,@Alabama State,11,3,Samford,8
2021-03-12,@Alabama State,1,18,Bradley,-17
2021-03-13,@Alabama State,7,11,Bradley,-4
2021-03-14,@Alabama State,9,8,Bradley,1
2021-03-19,@Alabama State,10,1,Mississippi Valley State,9
2021-03-20,@Alabama State,14,0,Mississippi Valley State,14
2021-03-21,@Alabama State,8,2,Mississippi Valley State,6
2021-03-24,@Alabama State,3,16,Troy,-13
2021-03-26,@Alabama State,6,0,Alcorn State,6
2021-03-27,@Alabama State,11,1,Alcorn State,10
2021-03-27,@Alabama State,10,9,Alcorn State,1
2021-03-30,@Florida A&M,14,15,Florida A&M,-1
2021-04-01,@Alabama A&M,8,10,Alabama A&M,-2
2021-04-02,@Alabama A&M,15,0,Alabama A&M,15
2021-04-03,@Alabama A&M,15,1,Alabama A&M,14
2021-04-06,@Alabama State,10,3,North Alabama,7
2021-04-07,@Alabama State,10,14,Jacksonville State,-4
2021-04-09,@Jackson State,3,8,Jackson State,-5
2021-04-10,@Jackson State,8,9,Jackson State,-1
2021-04-11,@Jackson State,2,4,Jackson State,-2
2021-04-13,@Alabama State,7,6,Florida A&M,1
2021-04-16,@Alabama State,16,6,Grambling State,10
2021-04-17,@Alabama State,12,2,Grambling State,10
2021-04-18,@Alabama State,7,6,Grambling State,1
2021-04-30,@Alcorn State,13,0,Alcorn State,13
2021-05-01,@Alcorn State,12,3,Alcorn State,9
2021-05-01,@Alcorn State,3,0,Alcorn State,3
2021-05-05,@North Alabama,7,6,North Alabama,1
2021-05-07,@Alabama State,17,3,Alabama A&M,14
2021-05-08,@Alabama State,9,3,Alabama A&M,6
2021-05-09,@Alabama State,32,6,Alabama A&M,26
2021-05-19,@Alabama State,0,3,Southern,-3
2021-05-20,@Alabama State,2,3,Alcorn State,-1
2021-02-19,@Alabama-Birmingham,2,6,Valparaiso,-4
2021-02-20,@Alabama-Birmingham,8,2,Valparaiso,6
2021-02-21,@Alabama-Birmingham,4,1,Valparaiso,3
2021-02-23,@Troy,3,10,Troy,-7
2021-02-26,@Alabama-Birmingham,22,2,Alabama A&M,20
2021-02-27,@Alabama-Birmingham,9,2,Alabama A&M,7
2021-02-28,@Alabama-Birmingham,7,3,Alabama A&M,4
2021-03-05,@Alabama-Birmingham,2,3,Kennesaw State,-1
2021-03-06,@Alabama-Birmingham,3,9,Kennesaw State,-6
2021-03-07,@Alabama-Birmingham,8,7,Kennesaw State,1
2021-03-09,@Alabama-Birmingham,5,6,Auburn,-1
2021-03-12,@Georgia Southern,7,11,Georgia Southern,-4
2021-03-13,@Georgia Southern,4,15,Georgia Southern,-11
2021-03-14,@Georgia Southern,5,9,Georgia Southern,-4
2021-03-19,@Alabama-Birmingham,0,1,Indiana State,-1
2021-03-20,@Alabama-Birmingham,8,10,Indiana State,-2
2021-03-21,@Alabama-Birmingham,11,4,Indiana State,7
2021-03-23,@Alabama-Birmingham,1,5,Samford,-4
2021-03-26,@Alabama-Birmingham,9,11,Middle Tennessee State,-2
2021-03-26,@Alabama-Birmingham,8,0,Middle Tennessee State,8
2021-03-27,@Alabama-Birmingham,8,5,Middle Tennessee State,3
2021-03-28,@Alabama-Birmingham,1,3,Middle Tennessee State,-2
2021-04-01,@Louisiana Tech,1,16,Louisiana Tech,-15
2021-04-02,@Louisiana Tech,4,6,Louisiana Tech,-2
2021-04-02,@Louisiana Tech,9,3,Louisiana Tech,6
2021-04-03,@Louisiana Tech,0,6,Louisiana Tech,-6
2021-04-09,@Southern Mississippi,2,7,Southern Mississippi,-5
2021-04-10,@Southern Mississippi,2,9,Southern Mississippi,-7
2021-04-10,@Southern Mississippi,1,4,Southern Mississippi,-3
2021-04-11,@Southern Mississippi,4,14,Southern Mississippi,-10
2021-04-13,@Alabama-Birmingham,4,12,Troy,-8
2021-04-16,@Alabama-Birmingham,7,6,Florida Atlantic,1
2021-04-17,@Alabama-Birmingham,4,2,Florida Atlantic,2
2021-04-17,@Alabama-Birmingham,1,2,Florida Atlantic,-1
2021-04-18,@Alabama-Birmingham,3,5,Florida Atlantic,-2
2021-04-20,@Mississippi State,7,19,Mississippi State,-12
2021-04-23,@Middle Tennessee State,4,2,Middle Tennessee State,2
2021-04-23,@Middle Tennessee State,2,5,Middle Tennessee State,-3
2021-04-24,@Middle Tennessee State,7,17,Middle Tennessee State,-10
2021-04-25,@Middle Tennessee State,2,3,Middle Tennessee State,-1
2021-04-27,@Alabama-Birmingham,3,9,Alabama,-6
2021-04-30,@Alabama-Birmingham,4,2,Texas-San Antonio,2
2021-05-01,@Alabama-Birmingham,6,4,Texas-San Antonio,2
2021-05-01,@Alabama-Birmingham,3,14,Texas-San Antonio,-11
2021-05-02,@Alabama-Birmingham,14,16,Texas-San Antonio,-2
2021-05-07,@Alabama-Birmingham,1,6,Rice,-5
2021-05-08,@Alabama-Birmingham,0,7,Rice,-7
2021-05-08,@Alabama-Birmingham,2,1,Rice,1
2021-05-09,@Alabama-Birmingham,5,10,Rice,-5
2021-05-14,@Marshall,6,8,Marshall,-2
2021-05-15,@Marshall,9,0,Marshall,9
2021-05-15,@Marshall,6,0,Marshall,6
2021-05-16,@Marshall,5,7,Marshall,-2
2021-05-18,@Samford,4,9,Samford,-5
2021-03-06,@Seton Hall,4,3,Seton Hall,1
2021-03-06,@Seton Hall,0,12,Seton Hall,-12
2021-03-07,@Central Connecticut State,6,15,Central Connecticut State,-9
2021-03-09,@Northeastern,1,10,Northeastern,-9
2021-03-10,@Merrimack,5,14,Merrimack,-9
2021-03-13,@Army,4,12,Army,-8
2021-03-13,@Army,4,1,Army,3
2021-03-20,@New Jersey Tech,3,5,New Jersey Tech,-2
2021-03-20,@New Jersey Tech,3,2,New Jersey Tech,1
2021-03-21,@New Jersey Tech,4,2,New Jersey Tech,2
2021-03-21,@New Jersey Tech,5,4,New Jersey Tech,1
2021-03-26,@Albany,11,14,Stony Brook,-3
2021-03-27,@Albany,3,9,Stony Brook,-6
2021-03-27,@Albany,6,14,Stony Brook,-8
2021-03-28,@Albany,0,11,Stony Brook,-11
2021-04-03,@Albany,5,1,Maryland-Baltimore County,4
2021-04-03,@Albany,6,0,Maryland-Baltimore County,6
2021-04-04,@Albany,4,7,Maryland-Baltimore County,-3
2021-04-04,@Albany,6,11,Maryland-Baltimore County,-5
2021-04-10,@Binghamton,5,3,Binghamton,2
2021-04-10,@Binghamton,7,3,Binghamton,4
2021-04-17,@Albany,2,5,Massachusetts-Lowell,-3
2021-04-17,@Albany,18,4,Massachusetts-Lowell,14
2021-04-18,@Albany,11,10,Massachusetts-Lowell,1
2021-04-18,@Albany,4,1,Massachusetts-Lowell,3
2021-04-23,@Hartford,3,4,Hartford,-1
2021-04-23,@Hartford,10,1,Hartford,9
2021-04-24,@Hartford,7,8,Hartford,-1
2021-04-24,@Hartford,6,12,Hartford,-6
2021-05-01,@Albany,2,14,Maine,-12
2021-05-01,@Albany,6,7,Maine,-1
2021-05-02,@Albany,23,11,Maine,12
2021-05-02,@Albany,4,3,Maine,1
2021-05-08,@Albany,3,2,Hartford,1
2021-05-08,@Albany,0,4,Hartford,-4
2021-05-09,@Albany,11,7,Hartford,4
2021-05-09,@Albany,5,4,Hartford,1
2021-05-15,@Massachusetts-Lowell,3,4,Massachusetts-Lowell,-1
2021-05-15,@Massachusetts-Lowell,7,4,Massachusetts-Lowell,3
2021-05-16,@Massachusetts-Lowell,4,3,Massachusetts-Lowell,1
2021-05-16,@Massachusetts-Lowell,6,7,Massachusetts-Lowell,-1
2021-05-21,@Maine,9,3,Maine,6
2021-05-21,@Maine,3,0,Maine,3
2021-05-22,@Maine,2,4,Maine,-2
2021-05-22,@Maine,5,6,Maine,-1
2021-05-27,@Albany,4,5,New Jersey Tech,-1
2021-05-28,@Stony Brook,2,3,Stony Brook,-1
2021-03-05,@Mississippi Valley State,16,3,Mississippi Valley State,13
2021-03-06,@Mississippi Valley State,9,1,Mississippi Valley State,8
2021-03-07,@Mississippi Valley State,14,1,Mississippi Valley State,13
2021-03-09,@Mississippi,1,11,Mississippi,-10
2021-03-12,@Alcorn State,2,7,Jackson State,-5
2021-03-13,@Alcorn State,5,10,Jackson State,-5
2021-03-14,@Alcorn State,6,30,Jackson State,-24
2021-03-19,@Alabama A&M,2,9,Alabama A&M,-7
2021-03-20,@Alabama A&M,16,14,Alabama A&M,2
2021-03-21,@Alabama A&M,12,0,Alabama A&M,12
2021-03-26,@Alabama State,0,6,Alabama State,-6
2021-03-27,@Alabama State,1,11,Alabama State,-10
2021-03-27,@Alabama State,9,10,Alabama State,-1
2021-04-06,@Mississippi,1,8,Mississippi,-7
2021-04-11,@Alcorn State,14,9,Mississippi Valley State,5
2021-04-16,@Jackson State,0,10,Jackson State,-10
2021-04-17,@Jackson State,4,6,Jackson State,-2
2021-04-18,@Jackson State,0,11,Jackson State,-11
2021-04-22,@Alcorn State,5,12,Alabama A&M,-7
2021-04-23,@Alcorn State,3,4,Alabama A&M,-1
2021-04-23,@Alcorn State,2,5,Alabama A&M,-3
2021-04-30,@Alcorn State,0,13,Alabama State,-13
2021-05-01,@Alcorn State,3,12,Alabama State,-9
2021-05-01,@Alcorn State,0,3,Alabama State,-3
2021-05-19,@Prairie View A&M,0,2,Prairie View A&M,-2
2021-05-20,@Alabama State,3,2,Alabama State,1
2021-05-21,@Southern,5,10,Southern,-5
2021-02-20,@Winthrop,4,0,Winthrop,4
2021-02-20,@Winthrop,4,1,Winthrop,3
2021-02-21,@Winthrop,9,10,Winthrop,-1
2021-02-23,@East Tennessee State,5,4,East Tennessee State,1
2021-02-27,@Appalachian State,6,2,North Carolina A&T,4
2021-02-27,@Appalachian State,7,6,North Carolina A&T,1
2021-02-28,@North Carolina A&T,3,11,North Carolina A&T,-8
2021-03-02,@Appalachian State,14,7,North Carolina A&T,7
2021-03-05,@East Carolina,2,13,East Carolina,-11
2021-03-06,@East Carolina,2,5,East Carolina,-3
2021-03-07,@East Carolina,2,10,East Carolina,-8
2021-03-12,@North Carolina-Wilmington,1,6,North Carolina-Wilmington,-5
2021-03-13,@North Carolina-Wilmington,1,4,North Carolina-Wilmington,-3
2021-03-14,@North Carolina-Wilmington,1,7,North Carolina-Wilmington,-6
2021-03-16,@Appalachian State,14,5,North Carolina A&T,9
2021-03-19,@Appalachian State,5,4,Arkansas State,1
2021-03-20,@Appalachian State,8,3,Arkansas State,5
2021-03-21,@Appalachian State,12,2,Arkansas State,10
2021-03-23,@North Carolina-Charlotte,5,15,North Carolina-Charlotte,-10
2021-03-26,@Georgia Southern,1,3,Georgia Southern,-2
2021-03-27,@Georgia Southern,2,10,Georgia Southern,-8
2021-03-28,@Georgia Southern,3,1,Georgia Southern,2
2021-03-30,@Wake Forest,7,15,Wake Forest,-8
2021-04-06,@North Carolina State,2,13,North Carolina State,-11
2021-04-09,@Appalachian State,4,2,Georgia State,2
2021-04-11,@Appalachian State,13,15,Georgia State,-2
2021-04-11,@Appalachian State,9,7,Georgia State,2
2021-04-13,@Appalachian State,0,12,Wake Forest,-12
2021-04-16,@Lipscomb,9,5,Lipscomb,4
2021-04-17,@Lipscomb,2,4,Lipscomb,-2
2021-04-18,@Lipscomb,4,3,Lipscomb,1
2021-04-20,@Appalachian State,8,11,North Carolina-Charlotte,-3
2021-04-23,@Troy,0,2,Troy,-2
2021-04-25,@Troy,2,12,Troy,-10
2021-04-25,@Troy,4,9,Troy,-5
2021-04-27,@Appalachian State,3,7,North Carolina State,-4
2021-04-30,@Appalachian State,6,4,Louisiana-Monroe,2
2021-05-01,@Appalachian State,7,10,Louisiana-Monroe,-3
2021-05-02,@Appalachian State,5,13,Louisiana-Monroe,-8
2021-05-07,"@Miami, Florida",2,4,"Miami, Florida",-2
2021-05-08,"@Miami, Florida",1,16,"Miami, Florida",-15
2021-05-09,"@Miami, Florida",2,10,"Miami, Florida",-8
2021-05-11,@Appalachian State,5,10,East Tennessee State,-5
2021-05-14,@Arkansas-Little Rock,2,1,Arkansas-Little Rock,1
2021-05-15,@Arkansas-Little Rock,2,4,Arkansas-Little Rock,-2
2021-05-16,@Arkansas-Little Rock,5,0,Arkansas-Little Rock,5
2021-05-18,@South Carolina,0,2,South Carolina,-2
2021-05-20,@Appalachian State,6,4,South Alabama,2
2021-05-21,@Appalachian State,4,2,South Alabama,2
2021-05-22,@Appalachian State,3,13,South Alabama,-10
2021-05-25,@Appalachian State,1,0,Texas State,1
2021-05-27,@Louisiana-Lafayette,2,7,Louisiana-Lafayette,-5
2021-02-19,@Arizona,3,0,Ball State,3
2021-02-20,@Arizona,7,8,Ball State,-1
2021-02-21,@Arizona,2,5,Ball State,-3
2021-02-22,@Arizona,11,5,Ball State,6
2021-02-25,@Arizona,7,4,Southeastern Louisiana,3
2021-02-26,@Arizona,13,11,Southeastern Louisiana,2
2021-02-27,@Arizona,4,3,Southeastern Louisiana,1
2021-02-28,@Arizona,14,2,Southeastern Louisiana,12
2021-03-04,@Oklahoma,20,13,Oklahoma,7
2021-03-05,@Arizona,12,1,Oklahoma,11
2021-03-06,@Arizona,15,8,Dallas Baptist,7
2021-03-07,@Missouri,8,4,Missouri,4
2021-03-11,@Arizona,8,5,Wichita State,3
2021-03-12,@Arizona,9,10,Wichita State,-1
2021-03-13,@Arizona,2,5,Air Force,-3
2021-03-14,@Arizona,14,5,Air Force,9
2021-03-19,@UCLA,2,3,UCLA,-1
2021-03-20,@UCLA,7,3,UCLA,4
2021-03-21,@UCLA,3,11,UCLA,-8
2021-03-22,@Loyola Marymount,18,2,Loyola Marymount,16
2021-03-26,@Arizona,5,4,Oregon,1
2021-03-27,@Arizona,15,2,Oregon,13
2021-03-28,@Arizona,13,18,Oregon,-5
2021-04-01,@Arizona State,10,5,Arizona State,5
2021-04-02,@Arizona State,7,6,Arizona State,1
2021-04-03,@Arizona State,2,3,Arizona State,-1
2021-04-06,@Arizona,14,2,Arizona State,12
2021-04-09,@Arizona,5,1,California,4
2021-04-10,@Arizona,4,3,California,1
2021-04-11,@Arizona,1,9,California,-8
2021-04-13,@Grand Canyon,4,5,Grand Canyon,-1
2021-04-16,@Washington State,2,21,Washington State,-19
2021-04-17,@Washington State,13,8,Washington State,5
2021-04-18,@Washington State,14,8,Washington State,6
2021-04-20,@Arizona,11,4,New Mexico State,7
2021-04-23,@Arizona,8,5,Southern California,3
2021-04-24,@Arizona,10,6,Southern California,4
2021-04-25,@Arizona,8,4,Southern California,4
2021-04-30,@Arizona,11,1,Utah,10
2021-05-01,@Arizona,4,3,Utah,1
2021-05-02,@Arizona,15,3,Utah,12
2021-05-04,@Arizona,13,2,Grand Canyon,11
2021-05-07,@Stanford,4,5,Stanford,-1
2021-05-08,@Stanford,20,2,Stanford,18
2021-05-09,@Stanford,2,8,Stanford,-6
2021-05-14,@Arizona,17,16,Washington,1
2021-05-15,@Arizona,4,1,Washington,3
2021-05-16,@Arizona,11,2,Washington,9
2021-05-18,@Arizona,14,3,New Mexico State,11
2021-05-21,@Oregon State,12,4,Oregon State,8
2021-05-22,@Oregon State,1,3,Oregon State,-2
2021-05-23,@Oregon State,6,5,Oregon State,1
2021-05-27,@Arizona,4,2,Dixie State,2
2021-05-28,@Arizona,9,11,Dixie State,-2
2021-05-29,@Arizona,5,4,Dixie State,1
2021-06-04,@Arizona,12,6,Grand Canyon,6
2021-06-05,@UC Santa Barbara,4,0,UC Santa Barbara,4
2021-06-06,@Arizona,5,2,UC Santa Barbara,3
2021-06-11,@Arizona,9,3,Mississippi,6
2021-06-12,@Mississippi,3,12,Mississippi,-9
2021-06-13,@Arizona,16,3,Mississippi,13
2021-06-19,@Vanderbilt,6,7,Vanderbilt,-1
2021-06-21,@Arizona,5,14,Stanford,-9
2021-02-19,@Arizona State,2,4,Sacramento State,-2
2021-02-20,@Arizona State,2,1,Sacramento State,1
2021-02-21,@Arizona State,3,1,Sacramento State,2
2021-02-26,@Arizona State,2,3,Hawaii,-1
2021-02-27,@Arizona State,6,5,Hawaii,1
2021-02-27,@Arizona State,9,6,Hawaii,3
2021-03-02,@Arizona State,13,4,Nevada,9
2021-03-05,@Arizona State,4,3,Utah,1
2021-03-06,@Arizona State,4,1,Utah,3
2021-03-07,@Arizona State,5,0,Utah,5
2021-03-12,@Arizona State,10,0,Cal State Fullerton,10
2021-03-13,@Arizona State,6,4,Cal State Fullerton,2
2021-03-14,@Arizona State,5,2,Cal State Fullerton,3
2021-03-16,@Arizona State,9,10,Nevada-Las Vegas,-1
2021-03-19,@Oregon,6,3,Oregon,3
2021-03-20,@Oregon,1,7,Oregon,-6
2021-03-21,@Oregon,3,5,Oregon,-2
2021-03-26,@Arizona State,10,0,Washington State,10
2021-03-27,@Arizona State,5,4,Washington State,1
2021-03-28,@Arizona State,9,0,Washington State,9
2021-04-01,@Arizona State,5,10,Arizona,-5
2021-04-02,@Arizona State,6,7,Arizona,-1
2021-04-03,@Arizona State,3,2,Arizona,1
2021-04-06,@Arizona,2,14,Arizona,-12
2021-04-09,@Washington,3,2,Washington,1
2021-04-10,@Washington,8,1,Washington,7
2021-04-11,@Washington,6,13,Washington,-7
2021-04-16,@Arizona State,9,5,Stanford,4
2021-04-17,@Arizona State,9,11,Stanford,-2
2021-04-18,@Arizona State,5,13,Stanford,-8
2021-04-20,@Arizona State,13,10,Grand Canyon,3
2021-04-21,@Grand Canyon,1,4,Grand Canyon,-3
2021-04-23,@Utah,5,4,Utah,1
2021-04-24,@Utah,10,6,Utah,4
2021-04-25,@Utah,6,7,Utah,-1
2021-04-27,@Brigham Young,5,8,Brigham Young,-3
2021-04-30,@Arizona State,9,6,Rhode Island,3
2021-05-01,@Arizona State,8,6,Rhode Island,2
2021-05-02,@Arizona State,14,13,Rhode Island,1
2021-05-07,@California,2,7,California,-5
2021-05-08,@California,6,3,California,3
2021-05-09,@California,7,2,California,5
2021-05-11,@Nevada,14,11,Nevada,3
2021-05-14,@Arizona State,9,6,Oregon State,3
2021-05-15,@Arizona State,11,5,Oregon State,6
2021-05-16,@Arizona State,4,11,Oregon State,-7
2021-05-21,@Southern California,6,2,Southern California,4
2021-05-22,@Southern California,1,6,Southern California,-5
2021-05-23,@Southern California,10,7,Southern California,3
2021-05-27,@Arizona State,9,21,UCLA,-12
2021-05-28,@Arizona State,5,8,UCLA,-3
2021-05-29,@Arizona State,0,3,UCLA,-3
2021-06-04,@Arizona State,7,6,Fairfield,1
2021-06-05,@Texas,3,10,Texas,-7
2021-06-06,@Fairfield,7,9,Fairfield,-2
2021-02-20,@Texas Tech,13,9,Texas Tech,4
2021-02-21,@Arkansas,4,0,Texas,4
2021-02-22,@Texas Christian,4,1,Texas Christian,3
2021-02-25,@Arkansas,6,5,Southeast Missouri State,1
2021-02-26,@Arkansas,7,3,Southeast Missouri State,4
2021-02-27,@Arkansas,9,3,Southeast Missouri State,6
2021-02-28,@Arkansas,11,4,Southeast Missouri State,7
2021-03-05,@Arkansas,7,6,Murray State,1
2021-03-06,@Arkansas,11,6,Murray State,5
2021-03-07,@Arkansas,6,0,Murray State,6
2021-03-12,@Louisiana Tech,9,7,Louisiana Tech,2
2021-03-13,@Louisiana Tech,8,1,Louisiana Tech,7
2021-03-14,@Louisiana Tech,0,2,Louisiana Tech,-2
2021-03-16,@Arkansas,5,8,Oklahoma,-3
2021-03-19,@Arkansas,1,16,Alabama,-15
2021-03-20,@Arkansas,9,1,Alabama,8
2021-03-21,@Arkansas,3,1,Alabama,2
2021-03-23,@Arkansas,14,1,Memphis,13
2021-03-24,@Arkansas,9,4,Memphis,5
2021-03-26,@Mississippi State,8,2,Mississippi State,6
2021-03-27,@Mississippi State,11,5,Mississippi State,6
2021-03-28,@Mississippi State,6,4,Mississippi State,2
2021-03-30,@Arkansas,21,8,Central Arkansas,13
2021-04-01,@Arkansas,1,2,Auburn,-1
2021-04-02,@Arkansas,6,5,Auburn,1
2021-04-03,@Arkansas,6,5,Auburn,1
2021-04-06,@Arkansas,7,2,Arkansas-Little Rock,5
2021-04-07,@Arkansas,10,3,Arkansas-Little Rock,7
2021-04-10,@Mississippi,7,3,Mississippi,4
2021-04-10,@Mississippi,6,13,Mississippi,-7
2021-04-11,@Mississippi,18,14,Mississippi,4
2021-04-13,@Arkansas,12,4,Arkansas-Pine Bluff,8
2021-04-14,@Arkansas,26,1,Arkansas-Pine Bluff,25
2021-04-17,@Arkansas,13,0,Texas A&M,13
2021-04-17,@Arkansas,2,1,Texas A&M,1
2021-04-18,@Arkansas,10,11,Texas A&M,-1
2021-04-22,@South Carolina,6,1,South Carolina,5
2021-04-23,@South Carolina,2,6,South Carolina,-4
2021-04-23,@South Carolina,5,1,South Carolina,4
2021-04-30,@Louisiana State,7,0,Louisiana State,7
2021-05-01,@Louisiana State,4,5,Louisiana State,-1
2021-05-01,@Louisiana State,17,10,Louisiana State,7
2021-05-07,@Arkansas,3,0,Georgia,3
2021-05-08,@Arkansas,3,7,Georgia,-4
2021-05-09,@Arkansas,5,3,Georgia,2
2021-05-11,@Arkansas,8,4,Arkansas State,4
2021-05-14,@Tennessee,6,5,Tennessee,1
2021-05-15,@Tennessee,7,8,Tennessee,-1
2021-05-16,@Tennessee,3,2,Tennessee,1
2021-05-20,@Arkansas,6,1,Florida,5
2021-05-21,@Arkansas,4,3,Florida,1
2021-05-22,@Arkansas,9,3,Florida,6
2021-05-26,@Arkansas,11,2,Georgia,9
2021-05-27,@Arkansas,6,4,Vanderbilt,2
2021-05-29,@Mississippi,3,2,Mississippi,1
2021-05-30,@Tennessee,7,2,Tennessee,5
2021-06-04,@Arkansas,13,8,New Jersey Tech,5
2021-06-05,@Arkansas,5,1,Nebraska,4
2021-06-06,@Nebraska,3,5,Nebraska,-2
2021-06-07,@Arkansas,6,2,Nebraska,4
2021-06-11,@Arkansas,21,2,North Carolina State,19
2021-06-12,@North Carolina State,5,6,North Carolina State,-1
2021-06-13,@Arkansas,2,3,North Carolina State,-1
2021-02-24,@Mississippi,1,12,Mississippi,-11
2021-02-27,@Arkansas State,5,8,Tennessee-Martin,-3
2021-02-27,@Arkansas State,5,21,Tennessee-Martin,-16
2021-03-02,@Murray State,6,9,Murray State,-3
2021-03-05,@Abilene Christian,3,26,Abilene Christian,-23
2021-03-06,@Abilene Christian,5,6,Abilene Christian,-1
2021-03-07,@Abilene Christian,4,9,Abilene Christian,-5
2021-03-09,@Arkansas State,10,2,Missouri State,8
2021-03-10,@Arkansas State,7,3,Missouri State,4
2021-03-14,@Oklahoma,1,9,Oklahoma,-8
2021-03-14,@Oklahoma,15,14,Oklahoma,1
2021-03-15,@Oklahoma,6,12,Oklahoma,-6
2021-03-19,@Appalachian State,4,5,Appalachian State,-1
2021-03-20,@Appalachian State,3,8,Appalachian State,-5
2021-03-21,@Appalachian State,2,12,Appalachian State,-10
2021-03-23,@Arkansas State,3,1,Murray State,2
2021-03-26,@Illinois State,3,6,Illinois State,-3
2021-03-28,@Illinois State,9,10,Illinois State,-1
2021-03-28,@Illinois State,13,6,Illinois State,7
2021-04-01,@Arkansas State,10,2,Arkansas-Little Rock,8
2021-04-02,@Arkansas State,4,0,Arkansas-Little Rock,4
2021-04-03,@Arkansas State,10,6,Arkansas-Little Rock,4
2021-04-09,@Louisiana-Lafayette,3,10,Louisiana-Lafayette,-7
2021-04-10,@Louisiana-Lafayette,0,9,Louisiana-Lafayette,-9
2021-04-11,@Louisiana-Lafayette,16,11,Louisiana-Lafayette,5
2021-04-13,@Mississippi State,10,18,Mississippi State,-8
2021-04-16,@Arkansas State,5,7,Texas-Arlington,-2
2021-04-17,@Arkansas State,2,9,Texas-Arlington,-7
2021-04-18,@Arkansas State,5,3,Texas-Arlington,2
2021-04-20,@Central Arkansas,3,5,Central Arkansas,-2
2021-04-23,@Texas State,4,11,Texas State,-7
2021-04-24,@Texas State,5,6,Texas State,-1
2021-04-25,@Texas State,12,1,Texas State,11
2021-04-30,@Austin Peay State,12,7,Austin Peay State,5
2021-05-01,@Austin Peay State,11,5,Austin Peay State,6
2021-05-02,@Austin Peay State,9,4,Austin Peay State,5
2021-05-04,@Mississippi,12,15,Mississippi,-3
2021-05-07,@Arkansas State,6,1,Georgia Southern,5
2021-05-08,@Arkansas State,4,0,Georgia Southern,4
2021-05-08,@Arkansas State,2,3,Georgia Southern,-1
2021-05-11,@Arkansas,4,8,Arkansas,-4
2021-05-14,@Troy,4,12,Troy,-8
2021-05-15,@Troy,1,3,Troy,-2
2021-05-16,@Troy,9,5,Troy,4
2021-05-20,@Arkansas State,12,6,Louisiana-Monroe,6
2021-05-21,@Arkansas State,7,10,Louisiana-Monroe,-3
2021-05-22,@Arkansas State,4,6,Louisiana-Monroe,-2
2021-05-25,@Troy,9,6,Troy,3
2021-05-27,@Texas-Arlington,3,8,Texas-Arlington,-5
2021-02-21,@Oral Roberts,4,3,Oral Roberts,1
2021-02-22,@Oral Roberts,3,7,Oral Roberts,-4
2021-02-24,@Oklahoma State,2,7,Oklahoma State,-5
2021-02-26,@Arkansas-Little Rock,1,17,Eastern Illinois,-16
2021-02-26,@Arkansas-Little Rock,6,12,Eastern Illinois,-6
2021-02-27,@Arkansas-Little Rock,6,5,Eastern Illinois,1
2021-03-03,@Arkansas-Little Rock,5,3,Central Arkansas,2
2021-03-05,@North Alabama,4,6,North Alabama,-2
2021-03-06,@North Alabama,9,1,North Alabama,8
2021-03-07,@North Alabama,10,3,North Alabama,7
2021-03-12,@Auburn,0,7,Auburn,-7
2021-03-13,@Auburn,0,6,Auburn,-6
2021-03-14,@Auburn,12,6,Auburn,6
2021-03-19,@Arkansas-Little Rock,2,1,Texas State,1
2021-03-20,@Arkansas-Little Rock,12,0,Texas State,12
2021-03-21,@Arkansas-Little Rock,7,4,Texas State,3
2021-03-26,@Southern Illinois,7,10,Southern Illinois,-3
2021-03-27,@Southern Illinois,11,5,Southern Illinois,6
2021-03-28,@Southern Illinois,11,5,Southern Illinois,6
2021-03-31,@Arkansas-Little Rock,7,2,Arkansas-Pine Bluff,5
2021-04-01,@Arkansas State,2,10,Arkansas State,-8
2021-04-02,@Arkansas State,0,4,Arkansas State,-4
2021-04-03,@Arkansas State,6,10,Arkansas State,-4
2021-04-06,@Arkansas,2,7,Arkansas,-5
2021-04-07,@Arkansas,3,10,Arkansas,-7
2021-04-09,@Arkansas-Little Rock,7,3,South Alabama,4
2021-04-10,@Arkansas-Little Rock,4,2,South Alabama,2
2021-04-11,@Arkansas-Little Rock,9,8,South Alabama,1
2021-04-13,@Central Arkansas,2,4,Central Arkansas,-2
2021-04-17,@Louisiana-Monroe,2,0,Louisiana-Monroe,2
2021-04-18,@Louisiana-Monroe,3,5,Louisiana-Monroe,-2
2021-04-19,@Louisiana-Monroe,4,5,Louisiana-Monroe,-1
2021-04-20,@Mississippi,6,11,Mississippi,-5
2021-04-23,@Arkansas-Little Rock,8,2,Louisiana-Lafayette,6
2021-04-24,@Arkansas-Little Rock,4,3,Louisiana-Lafayette,1
2021-04-25,@Arkansas-Little Rock,4,7,Louisiana-Lafayette,-3
2021-05-01,@Texas-Arlington,0,1,Texas-Arlington,-1
2021-05-02,@Texas-Arlington,0,3,Texas-Arlington,-3
2021-05-02,@Texas-Arlington,4,5,Texas-Arlington,-1
2021-05-07,@Sam Houston State,5,3,Sam Houston State,2
2021-05-08,@Sam Houston State,4,9,Sam Houston State,-5
2021-05-09,@Sam Houston State,4,8,Sam Houston State,-4
2021-05-12,@Mississippi,4,9,Mississippi,-5
2021-05-14,@Arkansas-Little Rock,1,2,Appalachian State,-1
2021-05-15,@Arkansas-Little Rock,4,2,Appalachian State,2
2021-05-16,@Arkansas-Little Rock,0,5,Appalachian State,-5
2021-05-20,@Georgia State,7,3,Georgia State,4
2021-05-21,@Georgia State,0,5,Georgia State,-5
2021-05-22,@Georgia State,10,11,Georgia State,-1
2021-05-25,@Arkansas-Little Rock,1,15,Coastal Carolina,-14
2021-05-27,@Arkansas-Little Rock,2,6,South Alabama,-4
2021-02-23,@Tennessee,1,21,Tennessee,-20
2021-02-24,@Tennessee,6,14,Tennessee,-8
2021-02-26,@Jackson State,5,9,Jackson State,-4
2021-02-27,@Jackson State,2,13,Jackson State,-11
2021-02-28,@Jackson State,11,17,Jackson State,-6
2021-03-02,@Tarleton State,1,23,Tarleton State,-22
2021-03-03,@Tarleton State,6,16,Tarleton State,-10
2021-03-12,@Texas Southern,1,11,Texas Southern,-10
2021-03-13,@Texas Southern,14,10,Texas Southern,4
2021-03-13,@Texas Southern,14,3,Texas Southern,11
2021-03-16,@Texas Christian,2,20,Texas Christian,-18
2021-03-19,@Arkansas-Pine Bluff,2,5,Prairie View A&M,-3
2021-03-26,@Arkansas-Pine Bluff,8,11,Southern,-3
2021-03-27,@Arkansas-Pine Bluff,8,15,Southern,-7
2021-03-28,@Arkansas-Pine Bluff,5,7,Southern,-2
2021-03-31,@Arkansas-Little Rock,2,7,Arkansas-Little Rock,-5
2021-04-02,@Arkansas-Pine Bluff,1,11,Grambling State,-10
2021-04-03,@Arkansas-Pine Bluff,8,11,Grambling State,-3
2021-04-04,@Arkansas-Pine Bluff,5,7,Grambling State,-2
2021-04-06,@Kansas State,2,12,Kansas State,-10
2021-04-07,@Kansas State,0,12,Kansas State,-12
2021-04-13,@Arkansas,4,12,Arkansas,-8
2021-04-14,@Arkansas,1,26,Arkansas,-25
2021-04-17,@Arkansas-Pine Bluff,3,2,Texas Southern,1
2021-04-17,@Arkansas-Pine Bluff,2,11,Texas Southern,-9
2021-04-18,@Arkansas-Pine Bluff,6,5,Texas Southern,1
2021-04-20,@Oklahoma State,0,28,Oklahoma State,-28
2021-04-21,@Oklahoma State,2,12,Oklahoma State,-10
2021-04-24,@Prairie View A&M,1,8,Prairie View A&M,-7
2021-04-24,@Prairie View A&M,8,11,Prairie View A&M,-3
2021-04-25,@Prairie View A&M,7,15,Prairie View A&M,-8
2021-04-27,@Arkansas-Pine Bluff,2,3,Tennessee-Martin,-1
2021-04-30,@Southern,3,8,Southern,-5
2021-05-01,@Southern,5,11,Southern,-6
2021-05-01,@Southern,6,3,Southern,3
2021-05-07,@Grambling State,14,6,Grambling State,8
2021-05-08,@Grambling State,9,8,Grambling State,1
2021-05-08,@Grambling State,18,9,Grambling State,9
2021-02-19,@North Carolina Central,4,9,North Carolina Central,-5
2021-02-20,@North Carolina Central,1,8,North Carolina Central,-7
2021-02-21,@North Carolina Central,4,5,North Carolina Central,-1
2021-02-26,@Army,2,1,Austin Peay State,1
2021-02-27,@Army,5,2,Austin Peay State,3
2021-02-28,@Army,7,12,Austin Peay State,-5
2021-03-05,@Air Force,1,4,Air Force,-3
2021-03-06,@Army,1,12,Air Force,-11
2021-03-07,@Air Force,4,5,Air Force,-1
2021-03-13,@Army,1,4,Albany,-3
2021-03-13,@Army,12,4,Albany,8
2021-03-20,@Bucknell,5,14,Bucknell,-9
2021-03-20,@Bucknell,0,4,Bucknell,-4
2021-03-21,@Bucknell,14,3,Bucknell,11
2021-03-21,@Bucknell,1,7,Bucknell,-6
2021-03-27,@Army,6,5,Holy Cross,1
2021-03-27,@Army,7,3,Holy Cross,4
2021-03-30,@Army,3,2,Rhode Island,1
2021-04-03,@Army,5,4,Lafayette,1
2021-04-03,@Army,12,3,Lafayette,9
2021-04-04,@Lafayette,6,5,Lafayette,1
2021-04-04,@Lafayette,6,1,Lafayette,5
2021-04-06,@St. Joseph's,4,3,St. Joseph's,1
2021-04-13,@Fordham,2,3,Fordham,-1
2021-04-17,@Lehigh,6,2,Lehigh,4
2021-04-17,@Lehigh,5,4,Lehigh,1
2021-04-18,@Army,3,4,Lehigh,-1
2021-04-18,@Army,9,11,Lehigh,-2
2021-04-20,@Army,8,2,Fordham,6
2021-04-23,@Lafayette,13,14,Lafayette,-1
2021-04-23,@Lafayette,16,1,Lafayette,15
2021-04-24,@Army,6,5,Lafayette,1
2021-04-24,@Army,2,4,Lafayette,-2
2021-04-27,@Bryant,8,16,Bryant,-8
2021-05-01,@Holy Cross,3,4,Holy Cross,-1
2021-05-01,@Holy Cross,17,14,Holy Cross,3
2021-05-02,@Holy Cross,8,1,Holy Cross,7
2021-05-02,@Holy Cross,6,2,Holy Cross,4
2021-05-04,@Army,9,4,Sacred Heart,5
2021-05-05,@Fordham,11,8,Fordham,3
2021-05-08,@Army,7,8,Navy,-1
2021-05-08,@Army,6,1,Navy,5
2021-05-09,@Army,5,10,Navy,-5
2021-05-11,@Rhode Island,5,9,Rhode Island,-4
2021-05-11,@Rhode Island,8,1,Rhode Island,7
2021-05-15,@Army,1,10,Lafayette,-9
2021-05-15,@Army,8,6,Lafayette,2
2021-05-16,@Army,7,3,Lafayette,4
2021-05-26,@Lehigh,22,7,Lehigh,15
2021-05-27,@Lehigh,1,3,Lehigh,-2
2021-05-27,@Lehigh,6,1,Lehigh,5
2021-06-04,@Texas Tech,3,6,Texas Tech,-3
2021-06-05,@Army,6,13,UCLA,-7
2021-02-19,@Auburn,14,3,Presbyterian,11
2021-02-20,@Auburn,6,1,Presbyterian,5
2021-02-21,@Auburn,2,1,Presbyterian,1
2021-02-23,@Auburn,18,2,Alabama A&M,16
2021-02-24,@Auburn,33,0,Alabama A&M,33
2021-02-26,@Oklahoma,3,4,Oklahoma,-1
2021-02-27,@Auburn,6,12,Baylor,-6
2021-02-28,@Texas A&M,6,1,Texas A&M,5
2021-03-05,@Auburn,2,8,Boston College,-6
2021-03-06,@Auburn,16,1,Boston College,15
2021-03-07,@Auburn,9,11,Boston College,-2
2021-03-09,@Alabama-Birmingham,6,5,Alabama-Birmingham,1
2021-03-12,@Auburn,7,0,Arkansas-Little Rock,7
2021-03-13,@Auburn,6,0,Arkansas-Little Rock,6
2021-03-14,@Auburn,6,12,Arkansas-Little Rock,-6
2021-03-16,@Lipscomb,9,7,Lipscomb,2
2021-03-19,@Mississippi,0,1,Mississippi,-1
2021-03-20,@Mississippi,5,6,Mississippi,-1
2021-03-21,@Mississippi,11,19,Mississippi,-8
2021-03-26,@Auburn,6,8,Kentucky,-2
2021-03-27,@Auburn,6,7,Kentucky,-1
2021-03-27,@Auburn,4,6,Kentucky,-2
2021-04-01,@Arkansas,2,1,Arkansas,1
2021-04-02,@Arkansas,5,6,Arkansas,-1
2021-04-03,@Arkansas,5,6,Arkansas,-1
2021-04-09,@Auburn,5,6,Mississippi State,-1
2021-04-10,@Auburn,2,7,Mississippi State,-5
2021-04-11,@Auburn,10,19,Mississippi State,-9
2021-04-13,@Georgia Tech,7,3,Georgia Tech,4
2021-04-15,@Alabama,7,8,Alabama,-1
2021-04-16,@Alabama,5,4,Alabama,1
2021-04-17,@Alabama,9,10,Alabama,-1
2021-04-20,@Auburn,6,4,Samford,2
2021-04-21,@Auburn,8,7,Jacksonville State,1
2021-04-23,@Auburn,2,4,Florida,-2
2021-04-25,@Auburn,10,8,Florida,2
2021-04-25,@Auburn,4,6,Florida,-2
2021-04-29,@Georgia,0,4,Georgia,-4
2021-04-30,@Georgia,10,6,Georgia,4
2021-05-01,@Georgia,9,7,Georgia,2
2021-05-06,@Auburn,3,8,Louisiana State,-5
2021-05-07,@Auburn,6,9,Louisiana State,-3
2021-05-08,@Auburn,2,1,Louisiana State,1
2021-05-12,@Samford,1,6,Samford,-5
2021-05-14,@Auburn,5,4,Texas A&M,1
2021-05-15,@Auburn,9,11,Texas A&M,-2
2021-05-16,@Auburn,8,5,Texas A&M,3
2021-05-18,@Auburn,14,6,North Alabama,8
2021-05-20,@Missouri,15,6,Missouri,9
2021-05-21,@Missouri,3,0,Missouri,3
2021-05-22,@Missouri,6,7,Missouri,-1
2021-05-25,@Mississippi,4,7,Mississippi,-3
2021-02-20,@Dallas Baptist,2,13,Dallas Baptist,-11
2021-02-21,@Dallas Baptist,2,11,Dallas Baptist,-9
2021-02-22,@Dallas Baptist,2,12,Dallas Baptist,-10
2021-02-26,@Army,1,2,Army,-1
2021-02-27,@Army,2,5,Army,-3
2021-02-28,@Army,12,7,Army,5
2021-03-03,@Austin Peay State,3,5,Tennessee,-2
2021-03-05,@Northwestern State,8,10,Northwestern State,-2
2021-03-06,@Northwestern State,0,4,Northwestern State,-4
2021-03-07,@Northwestern State,3,2,Northwestern State,1
2021-03-13,@Austin Peay State,6,13,Tennessee Tech,-7
2021-03-14,@Austin Peay State,0,12,Tennessee Tech,-12
2021-03-14,@Austin Peay State,6,2,Tennessee Tech,4
2021-03-16,@Austin Peay State,2,4,Middle Tennessee State,-2
2021-03-19,@Southeast Missouri State,3,6,Southeast Missouri State,-3
2021-03-20,@Southeast Missouri State,5,6,Southeast Missouri State,-1
2021-03-20,@Southeast Missouri State,12,11,Southeast Missouri State,1
2021-03-23,@Bellarmine,9,1,Bellarmine,8
2021-03-26,@Austin Peay State,2,3,Belmont,-1
2021-03-26,@Austin Peay State,13,8,Belmont,5
2021-03-27,@Austin Peay State,11,8,Belmont,3
2021-03-30,@Lipscomb,7,14,Lipscomb,-7
2021-04-02,@Eastern Kentucky,15,9,Eastern Kentucky,6
2021-04-03,@Eastern Kentucky,3,1,Eastern Kentucky,2
2021-04-03,@Eastern Kentucky,4,9,Eastern Kentucky,-5
2021-04-06,@Southern Illinois,0,15,Southern Illinois,-15
2021-04-08,@Austin Peay State,13,4,Morehead State,9
2021-04-09,@Austin Peay State,9,14,Morehead State,-5
2021-04-09,@Austin Peay State,1,12,Morehead State,-11
2021-04-13,@Mississippi,1,13,Mississippi,-12
2021-04-16,@Tennessee-Martin,8,1,Tennessee-Martin,7
2021-04-17,@Tennessee-Martin,0,1,Tennessee-Martin,-1
2021-04-17,@Tennessee-Martin,10,6,Tennessee-Martin,4
2021-04-20,@Vanderbilt,0,7,Vanderbilt,-7
2021-04-23,@Austin Peay State,3,11,Southern Illinois-Edwardsville,-8
2021-04-23,@Austin Peay State,7,6,Southern Illinois-Edwardsville,1
2021-04-24,@Austin Peay State,7,6,Southern Illinois-Edwardsville,1
2021-04-27,@Austin Peay State,16,15,North Alabama,1
2021-04-28,@Austin Peay State,3,16,Southeast Missouri State,-13
2021-04-30,@Austin Peay State,7,12,Arkansas State,-5
2021-05-01,@Austin Peay State,5,11,Arkansas State,-6
2021-05-02,@Austin Peay State,4,9,Arkansas State,-5
2021-05-05,@Austin Peay State,10,3,Bellarmine,7
2021-05-07,@Eastern Illinois,7,5,Eastern Illinois,2
2021-05-07,@Eastern Illinois,4,7,Eastern Illinois,-3
2021-05-08,@Eastern Illinois,7,8,Eastern Illinois,-1
2021-05-11,@Belmont,5,4,Belmont,1
2021-05-14,@Austin Peay State,8,7,Jacksonville State,1
2021-05-15,@Austin Peay State,5,1,Jacksonville State,4
2021-05-15,@Austin Peay State,4,10,Jacksonville State,-6
2021-05-20,@Murray State,7,3,Murray State,4
2021-05-21,@Murray State,3,8,Murray State,-5
2021-05-21,@Murray State,9,3,Murray State,6
2021-05-27,@Southeast Missouri State,8,11,Southeast Missouri State,-3
2021-05-28,@Morehead State,3,1,Morehead State,2
2021-05-29,@Murray State,6,7,Murray State,-1
2021-02-19,@Arizona,0,3,Arizona,-3
2021-02-20,@Arizona,8,7,Arizona,1
2021-02-21,@Arizona,5,2,Arizona,3
2021-02-22,@Arizona,5,11,Arizona,-6
2021-02-26,@Bradley,4,3,Bradley,1
2021-02-26,@Ball State,5,0,Bradley,5
2021-02-27,@Bradley,0,6,Bradley,-6
2021-03-05,@Kentucky,3,2,Kentucky,1
2021-03-06,@Kentucky,0,6,Kentucky,-6
2021-03-07,@Kentucky,4,3,Kentucky,1
2021-03-12,@Old Dominion,3,6,Old Dominion,-3
2021-03-13,@Old Dominion,5,10,Old Dominion,-5
2021-03-14,@Old Dominion,1,2,Old Dominion,-1
2021-03-19,@Ball State,2,0,Western Michigan,2
2021-03-20,@Ball State,13,1,Western Michigan,12
2021-03-20,@Ball State,3,2,Western Michigan,1
2021-03-21,@Ball State,12,15,Western Michigan,-3
2021-03-26,@Ball State,7,6,Toledo,1
2021-03-27,@Ball State,3,6,Toledo,-3
2021-03-27,@Ball State,7,1,Toledo,6
2021-03-28,@Ball State,8,7,Toledo,1
2021-04-02,@Butler,7,2,Butler,5
2021-04-03,@Ball State,10,1,Butler,9
2021-04-03,@Ball State,16,10,Butler,6
2021-04-09,@Akron,7,3,Akron,4
2021-04-10,@Akron,10,0,Akron,10
2021-04-10,@Akron,4,2,Akron,2
2021-04-11,@Akron,13,2,Akron,11
2021-04-16,@Eastern Michigan,6,10,Eastern Michigan,-4
2021-04-17,@Eastern Michigan,1,2,Eastern Michigan,-1
2021-04-17,@Eastern Michigan,13,8,Eastern Michigan,5
2021-04-18,@Eastern Michigan,5,2,Eastern Michigan,3
2021-04-23,@Ball State,6,2,Northern Illinois,4
2021-04-23,@Ball State,3,1,Northern Illinois,2
2021-04-24,@Ball State,6,5,Northern Illinois,1
2021-04-25,@Ball State,11,1,Northern Illinois,10
2021-04-30,@Bowling Green State,12,0,Bowling Green State,12
2021-05-01,@Bowling Green State,6,2,Bowling Green State,4
2021-05-01,@Bowling Green State,11,7,Bowling Green State,4
2021-05-02,@Bowling Green State,5,8,Bowling Green State,-3
2021-05-07,@Central Michigan,3,7,Central Michigan,-4
2021-05-08,@Central Michigan,13,3,Central Michigan,10
2021-05-08,@Central Michigan,2,3,Central Michigan,-1
2021-05-09,@Central Michigan,8,7,Central Michigan,1
2021-05-14,@Ball State,8,2,Kent State,6
2021-05-15,@Ball State,4,9,Kent State,-5
2021-05-15,@Ball State,8,7,Kent State,1
2021-05-16,@Ball State,8,19,Kent State,-11
2021-05-21,@Ohio,4,3,Ohio,1
2021-05-22,@Ohio,9,2,Ohio,7
2021-05-22,@Ohio,1,5,Ohio,-4
2021-05-23,@Ohio,7,9,Ohio,-2
2021-05-29,@Ball State,12,2,"Miami, Ohio",10
2021-05-29,@Ball State,1,0,"Miami, Ohio",1
2021-05-30,@Ball State,5,2,"Miami, Ohio",3
2021-05-30,@Ball State,4,0,"Miami, Ohio",4
2021-02-21,@Texas-Rio Grande Valley,12,7,Texas-Rio Grande Valley,5
2021-02-21,@Texas-Rio Grande Valley,8,9,Texas-Rio Grande Valley,-1
2021-02-22,@Texas-Rio Grande Valley,4,7,Texas-Rio Grande Valley,-3
2021-02-26,@Baylor,4,12,Texas A&M,-8
2021-02-27,@Auburn,12,6,Auburn,6
2021-02-28,@Baylor,3,9,Oklahoma,-6
2021-03-02,@Baylor,4,0,Sam Houston State,4
2021-03-05,@Baylor,5,4,Memphis,1
2021-03-06,@Baylor,20,4,Memphis,16
2021-03-06,@Baylor,9,0,Memphis,9
2021-03-07,@Baylor,8,7,Memphis,1
2021-03-12,@Baylor,7,3,Xavier,4
2021-03-13,@Baylor,11,4,Xavier,7
2021-03-14,@Baylor,10,0,Xavier,10
2021-03-16,@Baylor,10,8,Texas-San Antonio,2
2021-03-17,@Baylor,12,2,Prairie View A&M,10
2021-03-19,@Baylor,3,5,Texas,-2
2021-03-20,@Baylor,3,4,Texas,-1
2021-03-21,@Baylor,11,2,Texas,9
2021-03-23,@Texas-Arlington,3,4,Texas-Arlington,-1
2021-03-26,@Texas Christian,1,3,Texas Christian,-2
2021-03-27,@Texas Christian,2,11,Texas Christian,-9
2021-03-28,@Texas Christian,1,10,Texas Christian,-9
2021-03-30,@Baylor,4,2,Texas State,2
2021-04-01,@Baylor,6,0,North Carolina A&T,6
2021-04-02,@Baylor,5,0,North Carolina A&T,5
2021-04-02,@Baylor,7,1,North Carolina A&T,6
2021-04-03,@Baylor,7,3,North Carolina A&T,4
2021-04-06,@Baylor,7,6,Texas-Arlington,1
2021-04-09,@Baylor,6,3,West Virginia,3
2021-04-10,@Baylor,7,4,West Virginia,3
2021-04-11,@Baylor,4,8,West Virginia,-4
2021-04-13,@Sam Houston State,4,1,Sam Houston State,3
2021-04-17,@Kansas,8,2,Kansas,6
2021-04-17,@Kansas,6,2,Kansas,4
2021-04-18,@Kansas,2,3,Kansas,-1
2021-04-23,@Texas Tech,12,4,Texas Tech,8
2021-04-24,@Texas Tech,1,4,Texas Tech,-3
2021-04-25,@Texas Tech,13,3,Texas Tech,10
2021-04-27,@Baylor,14,0,Prairie View A&M,14
2021-05-07,@Baylor,17,2,Kansas State,15
2021-05-08,@Baylor,3,10,Kansas State,-7
2021-05-09,@Baylor,23,3,Kansas State,20
2021-05-14,@Oklahoma State,7,8,Oklahoma State,-1
2021-05-15,@Oklahoma State,1,3,Oklahoma State,-2
2021-05-16,@Oklahoma State,9,3,Oklahoma State,6
2021-05-20,@Baylor,9,5,Oklahoma,4
2021-05-21,@Baylor,6,10,Oklahoma,-4
2021-05-22,@Baylor,5,6,Oklahoma,-1
2021-05-26,@Texas Tech,4,11,Texas Tech,-7
2021-05-27,@Baylor,4,9,Kansas State,-5
2021-02-23,@Belmont,5,1,North Alabama,4
2021-02-26,@Belmont,5,4,Northern Kentucky,1
2021-02-26,@Belmont,10,11,Northern Kentucky,-1
2021-02-27,@Belmont,3,2,Creighton,1
2021-02-27,@Belmont,3,9,Creighton,-6
2021-03-05,@Mississippi,4,12,Mississippi,-8
2021-03-06,@Mississippi,3,4,Mississippi,-1
2021-03-07,@Mississippi,7,8,Mississippi,-1
2021-03-11,@Tennessee-Martin,6,9,Tennessee-Martin,-3
2021-03-12,@Tennessee-Martin,5,10,Tennessee-Martin,-5
2021-03-12,@Tennessee-Martin,8,0,Tennessee-Martin,8
2021-03-16,@Vanderbilt,1,4,Vanderbilt,-3
2021-03-19,@Belmont,11,0,Southern Illinois-Edwardsville,11
2021-03-20,@Belmont,2,5,Southern Illinois-Edwardsville,-3
2021-03-20,@Belmont,2,1,Southern Illinois-Edwardsville,1
2021-03-23,@Tennessee Tech,4,11,Tennessee Tech,-7
2021-03-26,@Austin Peay State,8,13,Austin Peay State,-5
2021-03-26,@Austin Peay State,3,2,Austin Peay State,1
2021-03-27,@Austin Peay State,8,11,Austin Peay State,-3
2021-03-30,@Belmont,9,8,Tennessee-Martin,1
2021-03-31,@Belmont,6,1,Trevecca Nazarene,5
2021-04-02,@Belmont,2,5,Eastern Illinois,-3
2021-04-03,@Belmont,10,2,Eastern Illinois,8
2021-04-03,@Belmont,10,6,Eastern Illinois,4
2021-04-06,@Belmont,5,4,Lipscomb,1
2021-04-06,@Belmont,9,10,Lipscomb,-1
2021-04-10,@Jacksonville State,4,8,Jacksonville State,-4
2021-04-10,@Jacksonville State,5,3,Jacksonville State,2
2021-04-11,@Jacksonville State,2,7,Jacksonville State,-5
2021-04-13,@North Alabama,10,8,North Alabama,2
2021-04-17,@Belmont,8,5,Murray State,3
2021-04-17,@Belmont,8,2,Murray State,6
2021-04-18,@Belmont,0,2,Murray State,-2
2021-04-21,@Lipscomb,11,2,Lipscomb,9
2021-04-24,@Tennessee Tech,7,9,Tennessee Tech,-2
2021-04-25,@Tennessee Tech,9,7,Tennessee Tech,2
2021-04-25,@Tennessee Tech,9,8,Tennessee Tech,1
2021-04-27,@Belmont,6,7,Tennessee Tech,-1
2021-04-30,@Belmont,0,12,Southeast Missouri State,-12
2021-05-01,@Belmont,0,5,Southeast Missouri State,-5
2021-05-01,@Belmont,4,1,Southeast Missouri State,3
2021-05-05,@Murray State,3,4,Murray State,-1
2021-05-09,@Wake Forest,1,10,Wake Forest,-9
2021-05-09,@Wake Forest,1,11,Wake Forest,-10
2021-05-11,@Belmont,4,5,Austin Peay State,-1
2021-05-14,@Eastern Kentucky,1,8,Eastern Kentucky,-7
2021-05-15,@Eastern Kentucky,4,6,Eastern Kentucky,-2
2021-05-15,@Eastern Kentucky,2,3,Eastern Kentucky,-1
2021-05-18,@Tennessee,2,11,Tennessee,-9
2021-05-21,@Belmont,4,3,Morehead State,1
2021-05-22,@Belmont,6,5,Morehead State,1
2021-05-22,@Belmont,6,9,Morehead State,-3
2021-03-20,@Hartford,11,7,Hartford,4
2021-03-20,@Hartford,2,5,Hartford,-3
2021-03-21,@Hartford,2,6,Hartford,-4
2021-03-21,@Hartford,1,2,Hartford,-1
2021-03-27,@Binghamton,1,14,Massachusetts-Lowell,-13
2021-03-27,@Binghamton,3,2,Massachusetts-Lowell,1
2021-04-02,@Maine,0,2,Maine,-2
2021-04-02,@Maine,8,3,Maine,5
2021-04-03,@Maine,3,2,Maine,1
2021-04-03,@Maine,5,0,Maine,5
2021-04-10,@Binghamton,3,7,Albany,-4
2021-04-10,@Binghamton,3,5,Albany,-2
2021-04-17,@Binghamton,2,0,New Jersey Tech,2
2021-04-17,@Binghamton,1,0,New Jersey Tech,1
2021-04-18,@Binghamton,1,2,New Jersey Tech,-1
2021-04-18,@Binghamton,6,3,New Jersey Tech,3
2021-04-23,@Maryland-Baltimore County,9,15,Maryland-Baltimore County,-6
2021-04-23,@Maryland-Baltimore County,8,3,Maryland-Baltimore County,5
2021-04-24,@Maryland-Baltimore County,9,14,Maryland-Baltimore County,-5
2021-04-24,@Maryland-Baltimore County,6,4,Maryland-Baltimore County,2
2021-05-01,@Stony Brook,9,13,Stony Brook,-4
2021-05-01,@Stony Brook,10,0,Stony Brook,10
2021-05-02,@Stony Brook,6,2,Stony Brook,4
2021-05-02,@Stony Brook,1,5,Stony Brook,-4
2021-05-08,@Binghamton,9,0,Maryland-Baltimore County,9
2021-05-08,@Binghamton,3,2,Maryland-Baltimore County,1
2021-05-09,@Binghamton,0,1,Maryland-Baltimore County,-1
2021-05-09,@Binghamton,3,8,Maryland-Baltimore County,-5
2021-05-15,@New Jersey Tech,4,2,New Jersey Tech,2
2021-05-15,@New Jersey Tech,0,2,New Jersey Tech,-2
2021-05-16,@New Jersey Tech,4,11,New Jersey Tech,-7
2021-05-16,@New Jersey Tech,2,6,New Jersey Tech,-4
2021-05-21,@Binghamton,3,15,Stony Brook,-12
2021-05-21,@Binghamton,1,7,Stony Brook,-6
2021-05-22,@Binghamton,5,4,Stony Brook,1
2021-05-22,@Binghamton,3,6,Stony Brook,-3
2021-02-20,@Charleston Southern,12,1,Charleston Southern,11
2021-02-20,@Charleston Southern,12,4,Charleston Southern,8
2021-02-21,@Charleston Southern,10,2,Charleston Southern,8
2021-02-27,@Duke,10,6,Duke,4
2021-02-27,@Duke,3,10,Duke,-7
2021-02-28,@Duke,5,2,Duke,3
2021-03-03,@Boston College,6,4,Rhode Island,2
2021-03-05,@Auburn,8,2,Auburn,6
2021-03-06,@Auburn,1,16,Auburn,-15
2021-03-07,@Auburn,11,9,Auburn,2
2021-03-09,@Boston College,10,5,Maine,5
2021-03-12,@Louisville,3,7,Louisville,-4
2021-03-13,@Louisville,0,5,Louisville,-5
2021-03-14,@Louisville,6,8,Louisville,-2
2021-03-17,@Boston College,18,12,Holy Cross,6
2021-03-19,@Boston College,3,9,North Carolina,-6
2021-03-20,@Boston College,10,3,North Carolina,7
2021-03-21,@Boston College,4,5,North Carolina,-1
2021-03-24,@Boston College,10,9,Merrimack,1
2021-03-26,@Boston College,12,16,Clemson,-4
2021-03-27,@Boston College,3,9,Clemson,-6
2021-03-27,@Boston College,2,7,Clemson,-5
2021-03-30,@Connecticut,0,12,Connecticut,-12
2021-04-01,@Virginia Tech,7,3,Virginia Tech,4
2021-04-02,@Virginia Tech,5,6,Virginia Tech,-1
2021-04-03,@Virginia Tech,3,4,Virginia Tech,-1
2021-04-06,@Northeastern,5,3,Northeastern,2
2021-04-09,@Boston College,5,20,North Carolina State,-15
2021-04-10,@Boston College,4,5,North Carolina State,-1
2021-04-11,@Boston College,0,7,North Carolina State,-7
2021-04-16,@Florida State,2,10,Florida State,-8
2021-04-17,@Florida State,1,5,Florida State,-4
2021-04-18,@Florida State,5,3,Florida State,2
2021-04-21,@Boston College,4,6,Rhode Island,-2
2021-04-23,@Boston College,10,0,Notre Dame,10
2021-04-24,@Boston College,9,13,Notre Dame,-4
2021-04-24,@Boston College,2,5,Notre Dame,-3
2021-04-27,@Boston College,13,2,Holy Cross,11
2021-04-30,@Boston College,13,0,"Miami, Florida",13
2021-05-01,@Boston College,1,2,"Miami, Florida",-1
2021-05-02,@Boston College,11,6,"Miami, Florida",5
2021-05-04,@Massachusetts,2,3,Massachusetts,-1
2021-05-07,@Pittsburgh,1,4,Pittsburgh,-3
2021-05-08,@Pittsburgh,6,2,Pittsburgh,4
2021-05-08,@Pittsburgh,3,4,Pittsburgh,-1
2021-05-18,@Boston College,5,7,Merrimack,-2
2021-05-20,@Boston College,1,7,Virginia,-6
2021-05-21,@Boston College,2,9,Virginia,-7
2021-05-22,@Boston College,8,6,Virginia,2
2021-02-26,@Middle Tennessee State,4,5,Middle Tennessee State,-1
2021-02-27,@Middle Tennessee State,3,5,Middle Tennessee State,-2
2021-02-28,@Middle Tennessee State,0,7,Middle Tennessee State,-7
2021-03-05,@James Madison,10,6,James Madison,4
2021-03-06,@James Madison,4,15,James Madison,-11
2021-03-07,@James Madison,10,4,James Madison,6
2021-03-12,@Western Kentucky,3,4,Western Kentucky,-1
2021-03-13,@Western Kentucky,1,4,Western Kentucky,-3
2021-03-13,@Western Kentucky,1,3,Western Kentucky,-2
2021-03-14,@Western Kentucky,16,17,Western Kentucky,-1
2021-03-20,@Ohio,1,2,Ohio,-1
2021-03-21,@Ohio,5,2,Ohio,3
2021-03-21,@Ohio,6,2,Ohio,4
2021-03-22,@Ohio,11,5,Ohio,6
2021-03-26,@Akron,3,6,Akron,-3
2021-03-27,@Akron,7,1,Akron,6
2021-03-27,@Akron,6,0,Akron,6
2021-03-28,@Akron,3,2,Akron,1
2021-04-02,@Bowling Green State,1,14,Kent State,-13
2021-04-03,@Bowling Green State,6,10,Kent State,-4
2021-04-03,@Bowling Green State,4,13,Kent State,-9
2021-04-04,@Bowling Green State,5,10,Kent State,-5
2021-04-10,@Central Michigan,0,1,Central Michigan,-1
2021-04-10,@Central Michigan,3,2,Central Michigan,1
2021-04-11,@Central Michigan,1,5,Central Michigan,-4
2021-04-11,@Central Michigan,4,13,Central Michigan,-9
2021-04-23,@Western Michigan,5,7,Western Michigan,-2
2021-04-23,@Western Michigan,7,12,Western Michigan,-5
2021-04-24,@Western Michigan,3,2,Western Michigan,1
2021-04-25,@Western Michigan,20,6,Western Michigan,14
2021-04-30,@Bowling Green State,0,12,Ball State,-12
2021-05-01,@Bowling Green State,7,11,Ball State,-4
2021-05-01,@Bowling Green State,2,6,Ball State,-4
2021-05-02,@Bowling Green State,8,5,Ball State,3
2021-05-04,@Bowling Green State,7,1,"Miami, Ohio",6
2021-05-07,@Bowling Green State,8,10,Eastern Michigan,-2
2021-05-07,@Bowling Green State,0,8,Eastern Michigan,-8
2021-05-08,@Bowling Green State,0,3,Eastern Michigan,-3
2021-05-08,@Bowling Green State,5,6,Eastern Michigan,-1
2021-05-14,@Toledo,2,5,Toledo,-3
2021-05-15,@Toledo,5,12,Toledo,-7
2021-05-15,@Toledo,5,4,Toledo,1
2021-05-16,@Toledo,2,19,Toledo,-17
2021-05-18,@Bowling Green State,4,3,"Miami, Ohio",1
2021-05-18,@Bowling Green State,2,0,"Miami, Ohio",2
2021-05-25,@Bowling Green State,9,7,"Miami, Ohio",2
2021-05-29,@Bowling Green State,7,0,Northern Illinois,7
2021-05-29,@Bowling Green State,10,9,Northern Illinois,1
2021-05-30,@Bowling Green State,5,4,Northern Illinois,1
2021-05-30,@Bowling Green State,1,2,Northern Illinois,-1
2021-02-26,@Bradley,3,4,Ball State,-1
2021-02-26,@Ball State,0,5,Ball State,-5
2021-02-27,@Bradley,6,0,Ball State,6
2021-03-05,@New Orleans,0,5,New Orleans,-5
2021-03-06,@New Orleans,9,5,New Orleans,4
2021-03-07,@New Orleans,6,3,New Orleans,3
2021-03-12,@Alabama State,18,1,Alabama State,17
2021-03-13,@Alabama State,11,7,Alabama State,4
2021-03-14,@Alabama State,8,9,Alabama State,-1
2021-03-19,@Mercer,9,11,Mercer,-2
2021-03-20,@Mercer,5,15,Mercer,-10
2021-03-20,@Mercer,11,12,Mercer,-1
2021-03-27,@Creighton,4,6,Creighton,-2
2021-03-28,@Creighton,5,9,Creighton,-4
2021-03-30,@Bradley,7,2,Southern Illinois-Edwardsville,5
2021-04-01,@Missouri State,4,5,Missouri State,-1
2021-04-02,@Missouri State,3,4,Missouri State,-1
2021-04-02,@Missouri State,10,1,Missouri State,9
2021-04-03,@Missouri State,10,7,Missouri State,3
2021-04-09,@Bradley,3,5,Evansville,-2
2021-04-11,@Bradley,5,4,Evansville,1
2021-04-11,@Bradley,2,4,Evansville,-2
2021-04-16,@Bradley,4,5,Southern Illinois,-1
2021-04-17,@Bradley,2,1,Southern Illinois,1
2021-04-17,@Bradley,3,2,Southern Illinois,1
2021-04-18,@Bradley,6,0,Southern Illinois,6
2021-04-23,@Bradley,18,4,St. Louis,14
2021-04-24,@Bradley,6,9,St. Louis,-3
2021-04-25,@Bradley,13,3,St. Louis,10
2021-05-07,@Bradley,1,2,Valparaiso,-1
2021-05-07,@Bradley,9,5,Valparaiso,4
2021-05-08,@Bradley,3,2,Valparaiso,1
2021-05-08,@Bradley,3,10,Valparaiso,-7
2021-05-14,@Dallas Baptist,2,5,Dallas Baptist,-3
2021-05-14,@Dallas Baptist,8,4,Dallas Baptist,4
2021-05-15,@Dallas Baptist,13,10,Dallas Baptist,3
2021-05-15,@Dallas Baptist,6,16,Dallas Baptist,-10
2021-05-20,@Bradley,4,6,Illinois State,-2
2021-05-21,@Bradley,4,3,Illinois State,1
2021-05-22,@Bradley,3,1,Illinois State,2
2021-05-26,@Bradley,1,13,Southern Illinois,-12
2021-05-28,@Dallas Baptist,5,10,Dallas Baptist,-5
2021-02-20,@Texas State,9,4,Texas State,5
2021-02-20,@Texas State,4,5,Texas State,-1
2021-02-22,@Texas State,6,11,Texas State,-5
2021-02-23,@Texas State,7,6,Texas State,1
2021-02-24,@Texas,1,3,Texas,-2
2021-02-25,@Texas,6,12,Texas,-6
2021-02-26,@Texas,1,11,Texas,-10
2021-02-27,@Texas,5,4,Texas,1
2021-03-04,@Oregon State,0,1,Oregon State,-1
2021-03-05,@Oregon State,3,5,Oregon State,-2
2021-03-06,@Oregon State,3,4,Oregon State,-1
2021-03-11,@Utah,3,6,Utah,-3
2021-03-12,@Utah,1,7,Utah,-6
2021-03-16,@Dixie State,4,5,Dixie State,-1
2021-03-18,@Loyola Marymount,5,4,Loyola Marymount,1
2021-03-19,@Loyola Marymount,9,2,Loyola Marymount,7
2021-03-20,@Loyola Marymount,4,1,Loyola Marymount,3
2021-03-23,@Brigham Young,11,7,Utah Valley,4
2021-03-25,@Brigham Young,8,7,San Francisco,1
2021-03-26,@Brigham Young,6,10,San Francisco,-4
2021-03-27,@Brigham Young,1,3,San Francisco,-2
2021-04-01,@Santa Clara,0,5,Santa Clara,-5
2021-04-02,@Santa Clara,3,11,Santa Clara,-8
2021-04-03,@Santa Clara,3,1,Santa Clara,2
2021-04-08,@Brigham Young,3,5,Portland,-2
2021-04-09,@Brigham Young,1,0,Portland,1
2021-04-10,@Brigham Young,6,7,Portland,-1
2021-04-13,@Brigham Young,7,4,Utah,3
2021-04-15,@Nebraska-Omaha,1,2,Nebraska-Omaha,-1
2021-04-16,@Nebraska-Omaha,5,6,Nebraska-Omaha,-1
2021-04-17,@Nebraska-Omaha,1,4,Nebraska-Omaha,-3
2021-04-20,@Brigham Young,3,2,Dixie State,1
2021-04-22,@Gonzaga,1,12,Gonzaga,-11
2021-04-23,@Gonzaga,1,2,Gonzaga,-1
2021-04-24,@Gonzaga,3,7,Gonzaga,-4
2021-04-27,@Brigham Young,8,5,Arizona State,3
2021-04-29,@Brigham Young,12,0,St. Mary's,12
2021-04-30,@Brigham Young,4,2,St. Mary's,2
2021-05-01,@Brigham Young,4,3,St. Mary's,1
2021-05-04,@Utah Valley,11,4,Utah Valley,7
2021-05-06,@San Diego,6,4,San Diego,2
2021-05-07,@San Diego,11,10,San Diego,1
2021-05-08,@San Diego,12,13,San Diego,-1
2021-05-13,@Pacific,3,6,Pacific,-3
2021-05-14,@Pacific,5,0,Pacific,5
2021-05-15,@Pacific,6,0,Pacific,6
2021-05-18,@Brigham Young,5,11,Utah,-6
2021-05-20,@Brigham Young,3,6,Pepperdine,-3
2021-05-21,@Brigham Young,14,5,Pepperdine,9
2021-05-22,@Brigham Young,14,7,Pepperdine,7
2021-02-19,@High Point,2,0,High Point,2
2021-02-20,@High Point,7,6,High Point,1
2021-02-21,@High Point,2,3,High Point,-1
2021-02-26,@Coastal Carolina,1,8,Coastal Carolina,-7
2021-02-27,@Kennesaw State,6,7,Kennesaw State,-1
2021-02-28,@Bryant,7,9,West Virginia,-2
2021-03-13,@Rhode Island,0,7,Rhode Island,-7
2021-03-14,@Rhode Island,4,6,Rhode Island,-2
2021-03-16,@Northeastern,0,5,Northeastern,-5
2021-03-20,@Merrimack,10,0,Merrimack,10
2021-03-21,@Merrimack,14,0,Merrimack,14
2021-03-21,@Merrimack,18,1,Merrimack,17
2021-03-26,@Mount St. Mary's,15,2,Mount St. Mary's,13
2021-03-27,@Mount St. Mary's,13,4,Mount St. Mary's,9
2021-03-27,@Mount St. Mary's,7,2,Mount St. Mary's,5
2021-04-01,@Bryant,12,1,Wagner,11
2021-04-02,@Bryant,9,3,Wagner,6
2021-04-03,@Bryant,1,4,Wagner,-3
2021-04-06,@Connecticut,8,9,Connecticut,-1
2021-04-07,@Rhode Island,10,7,Rhode Island,3
2021-04-10,@Bryant,19,10,Fairleigh Dickinson,9
2021-04-10,@Bryant,14,0,Fairleigh Dickinson,14
2021-04-11,@Bryant,9,8,Fairleigh Dickinson,1
2021-04-23,@Central Connecticut State,4,2,Central Connecticut State,2
2021-04-24,@Central Connecticut State,8,6,Central Connecticut State,2
2021-04-24,@Central Connecticut State,5,13,Central Connecticut State,-8
2021-04-27,@Bryant,16,8,Army,8
2021-04-30,@Bryant,4,2,LIU-Brooklyn,2
2021-05-01,@Bryant,3,8,LIU-Brooklyn,-5
2021-05-02,@Bryant,5,0,LIU-Brooklyn,5
2021-05-08,@Bryant,6,0,Merrimack,6
2021-05-09,@Bryant,5,1,Merrimack,4
2021-05-09,@Bryant,9,3,Merrimack,6
2021-05-14,@Wagner,4,6,Wagner,-2
2021-05-15,@Wagner,6,0,Wagner,6
2021-05-16,@Wagner,7,5,Wagner,2
2021-05-20,@Bryant,20,3,Mount St. Mary's,17
2021-05-27,@Bryant,17,13,LIU-Brooklyn,4
2021-05-28,@Bryant,6,0,Central Connecticut State,6
2021-05-29,@Central Connecticut State,5,7,Central Connecticut State,-2
2021-05-30,@Central Connecticut State,2,5,Central Connecticut State,-3
2021-03-04,@Mount St. Mary's,2,3,Mount St. Mary's,-1
2021-03-06,@Bucknell,0,7,LaSalle,-7
2021-03-06,@Bucknell,4,5,LaSalle,-1
2021-03-13,@Lehigh,4,3,Lehigh,1
2021-03-13,@Lehigh,4,5,Lehigh,-1
2021-03-14,@Bucknell,10,17,Lehigh,-7
2021-03-20,@Bucknell,14,5,Army,9
2021-03-20,@Bucknell,4,0,Army,4
2021-03-21,@Bucknell,3,14,Army,-11
2021-03-21,@Bucknell,7,1,Army,6
2021-03-24,@Pittsburgh,9,17,Pittsburgh,-8
2021-03-27,@Bucknell,1,7,Navy,-6
2021-03-27,@Bucknell,11,1,Navy,10
2021-03-28,@Navy,10,15,Navy,-5
2021-04-03,@Holy Cross,0,7,Holy Cross,-7
2021-04-03,@Holy Cross,2,10,Holy Cross,-8
2021-04-04,@Holy Cross,1,2,Holy Cross,-1
2021-04-04,@Holy Cross,2,3,Holy Cross,-1
2021-04-10,@Bucknell,3,6,Lehigh,-3
2021-04-10,@Bucknell,8,9,Lehigh,-1
2021-04-12,@Lehigh,8,2,Lehigh,6
2021-04-17,@Navy,5,6,Navy,-1
2021-04-17,@Navy,4,2,Navy,2
2021-04-18,@Bucknell,10,3,Navy,7
2021-04-24,@Lehigh,3,1,Lehigh,2
2021-04-24,@Lehigh,4,7,Lehigh,-3
2021-04-25,@Bucknell,14,4,Lehigh,10
2021-05-01,@Connecticut,1,9,Connecticut,-8
2021-05-02,@Connecticut,6,13,Connecticut,-7
2021-05-05,@St. Joseph's,4,5,St. Joseph's,-1
2021-05-08,@Bucknell,4,10,Lafayette,-6
2021-05-08,@Bucknell,3,4,Lafayette,-1
2021-05-09,@Lafayette,13,8,Lafayette,5
2021-03-09,@Butler,16,4,DePauw,12
2021-03-12,@Butler,3,6,IPFW,-3
2021-03-13,@Butler,2,0,IPFW,2
2021-03-14,@Butler,6,9,IPFW,-3
2021-03-19,@Evansville,0,7,Evansville,-7
2021-03-20,@Evansville,12,8,Evansville,4
2021-03-21,@Evansville,1,10,Evansville,-9
2021-03-23,@Kentucky,5,6,Kentucky,-1
2021-03-26,@Butler,5,4,Valparaiso,1
2021-03-27,@Butler,13,10,Valparaiso,3
2021-03-27,@Butler,1,7,Valparaiso,-6
2021-04-02,@Butler,2,7,Ball State,-5
2021-04-03,@Ball State,10,16,Ball State,-6
2021-04-03,@Ball State,1,10,Ball State,-9
2021-04-09,@Seton Hall,5,7,Seton Hall,-2
2021-04-09,@Seton Hall,2,3,Seton Hall,-1
2021-04-10,@Seton Hall,4,7,Seton Hall,-3
2021-04-10,@Seton Hall,7,4,Seton Hall,3
2021-04-16,@Xavier,2,9,Xavier,-7
2021-04-17,@Xavier,2,7,Xavier,-5
2021-04-17,@Xavier,7,3,Xavier,4
2021-04-18,@Xavier,6,16,Xavier,-10
2021-04-23,@Butler,10,5,Villanova,5
2021-04-24,@Butler,1,8,Villanova,-7
2021-04-25,@Butler,11,3,Villanova,8
2021-05-02,@Butler,3,0,Northern Kentucky,3
2021-05-02,@Butler,4,6,Northern Kentucky,-2
2021-05-08,@Butler,10,11,Creighton,-1
2021-05-08,@Butler,2,8,Creighton,-6
2021-05-14,@Butler,0,4,St. John's,-4
2021-05-14,@Butler,0,9,St. John's,-9
2021-05-15,@Butler,4,1,St. John's,3
2021-05-15,@Butler,4,9,St. John's,-5
2021-05-20,@Georgetown,2,0,Georgetown,2
2021-05-20,@Georgetown,4,5,Georgetown,-1
2021-05-21,@Georgetown,13,7,Georgetown,6
2021-05-22,@Georgetown,11,3,Georgetown,8
2021-02-26,@Fresno State,2,13,Fresno State,-11
2021-02-27,@Fresno State,6,9,Fresno State,-3
2021-02-28,@Fresno State,9,4,Fresno State,5
2021-03-05,@CSU Bakersfield,4,12,Pacific,-8
2021-03-06,@CSU Bakersfield,5,8,Pacific,-3
2021-03-06,@CSU Bakersfield,10,9,Pacific,1
2021-03-07,@CSU Bakersfield,2,1,Pacific,1
2021-03-19,@CSU Bakersfield,15,9,UC Riverside,6
2021-03-20,@CSU Bakersfield,4,5,UC Riverside,-1
2021-03-20,@CSU Bakersfield,7,1,UC Riverside,6
2021-03-21,@CSU Bakersfield,9,7,UC Riverside,2
2021-04-09,@CSU Bakersfield,0,5,UC Davis,-5
2021-04-10,@CSU Bakersfield,7,9,UC Davis,-2
2021-04-10,@CSU Bakersfield,14,4,UC Davis,10
2021-04-11,@CSU Bakersfield,5,2,UC Davis,3
2021-04-16,@Hawaii,5,2,Hawaii,3
2021-04-17,@Hawaii,4,1,Hawaii,3
2021-04-17,@Hawaii,4,11,Hawaii,-7
2021-04-18,@Hawaii,7,4,Hawaii,3
2021-04-23,@UC San Diego,9,7,UC San Diego,2
2021-04-24,@UC San Diego,3,2,UC San Diego,1
2021-04-24,@UC San Diego,1,7,UC San Diego,-6
2021-04-25,@UC San Diego,2,1,UC San Diego,1
2021-04-30,@CSU Bakersfield,4,9,Cal State Northridge,-5
2021-05-01,@CSU Bakersfield,5,8,Cal State Northridge,-3
2021-05-01,@CSU Bakersfield,2,10,Cal State Northridge,-8
2021-05-02,@CSU Bakersfield,1,5,Cal State Northridge,-4
2021-05-07,@CSU Bakersfield,9,5,Cal Poly,4
2021-05-08,@CSU Bakersfield,5,1,Cal Poly,4
2021-05-08,@CSU Bakersfield,7,6,Cal Poly,1
2021-05-09,@CSU Bakersfield,6,4,Cal Poly,2
2021-05-14,@Long Beach State,1,5,Long Beach State,-4
2021-05-15,@Long Beach State,2,1,Long Beach State,1
2021-05-15,@Long Beach State,0,5,Long Beach State,-5
2021-05-16,@Long Beach State,2,3,Long Beach State,-1
2021-05-21,@CSU Bakersfield,5,11,UC Irvine,-6
2021-05-22,@CSU Bakersfield,11,9,UC Irvine,2
2021-05-22,@CSU Bakersfield,1,2,UC Irvine,-1
2021-05-23,@CSU Bakersfield,4,7,UC Irvine,-3
2021-05-28,@UC Santa Barbara,2,5,UC Santa Barbara,-3
2021-05-29,@UC Santa Barbara,3,13,UC Santa Barbara,-10
2021-05-29,@UC Santa Barbara,0,6,UC Santa Barbara,-6
2021-05-30,@UC Santa Barbara,5,11,UC Santa Barbara,-6
2021-02-19,@Cal Poly,4,0,Nevada,4
2021-02-20,@Cal Poly,1,2,Nevada,-1
2021-02-21,@Cal Poly,8,11,Nevada,-3
2021-02-22,@Cal Poly,6,12,Nevada,-6
2021-02-26,@Southern California,2,1,Southern California,1
2021-02-27,@Southern California,9,4,Southern California,5
2021-02-28,@Southern California,6,7,Southern California,-1
2021-03-05,@Cal Poly,17,3,Utah Valley,14
2021-03-06,@Cal Poly,5,1,Utah Valley,4
2021-03-07,@Cal Poly,6,0,Utah Valley,6
2021-03-12,@Cal Poly,5,4,UCLA,1
2021-03-13,@Cal Poly,12,13,UCLA,-1
2021-03-14,@Cal Poly,8,5,UCLA,3
2021-03-20,@Cal State Northridge,10,13,Cal State Northridge,-3
2021-03-21,@Cal State Northridge,7,6,Cal State Northridge,1
2021-03-21,@Cal State Northridge,12,1,Cal State Northridge,11
2021-03-22,@Cal State Northridge,10,8,Cal State Northridge,2
2021-03-26,@Cal Poly,2,5,UC San Diego,-3
2021-03-27,@Cal Poly,9,12,UC San Diego,-3
2021-03-27,@Cal Poly,1,6,UC San Diego,-5
2021-03-28,@Cal Poly,6,2,UC San Diego,4
2021-04-01,@Cal Poly,10,1,San Jose State,9
2021-04-02,@Cal Poly,2,10,San Jose State,-8
2021-04-03,@Cal Poly,3,0,San Jose State,3
2021-04-09,@Long Beach State,0,7,Long Beach State,-7
2021-04-10,@Long Beach State,7,5,Long Beach State,2
2021-04-10,@Long Beach State,1,2,Long Beach State,-1
2021-04-11,@Long Beach State,5,1,Long Beach State,4
2021-04-16,@Cal Poly,6,11,UC Irvine,-5
2021-04-17,@Cal Poly,1,4,UC Irvine,-3
2021-04-17,@Cal Poly,4,3,UC Irvine,1
2021-04-18,@Cal Poly,1,17,UC Irvine,-16
2021-04-23,@Cal Poly,4,2,UC Riverside,2
2021-04-24,@Cal Poly,8,2,UC Riverside,6
2021-04-24,@Cal Poly,6,9,UC Riverside,-3
2021-04-25,@Cal Poly,3,6,UC Riverside,-3
2021-04-30,@UC Santa Barbara,1,4,UC Santa Barbara,-3
2021-05-01,@UC Santa Barbara,1,2,UC Santa Barbara,-1
2021-05-01,@UC Santa Barbara,5,1,UC Santa Barbara,4
2021-05-02,@UC Santa Barbara,3,12,UC Santa Barbara,-9
2021-05-07,@CSU Bakersfield,5,9,CSU Bakersfield,-4
2021-05-08,@CSU Bakersfield,1,5,CSU Bakersfield,-4
2021-05-08,@CSU Bakersfield,6,7,CSU Bakersfield,-1
2021-05-09,@CSU Bakersfield,4,6,CSU Bakersfield,-2
2021-05-14,@Cal Poly,5,1,Cal State Fullerton,4
2021-05-15,@Cal Poly,13,3,Cal State Fullerton,10
2021-05-15,@Cal Poly,10,0,Cal State Fullerton,10
2021-05-16,@Cal Poly,9,1,Cal State Fullerton,8
2021-05-21,@UC Davis,2,5,UC Davis,-3
2021-05-22,@UC Davis,5,1,UC Davis,4
2021-05-22,@UC Davis,3,2,UC Davis,1
2021-05-23,@UC Davis,6,2,UC Davis,4
2021-05-28,@Cal Poly,13,3,Hawaii,10
2021-05-29,@Cal Poly,5,4,Hawaii,1
2021-05-29,@Cal Poly,14,4,Hawaii,10
2021-05-30,@Cal Poly,6,2,Hawaii,4
2021-02-20,@Cal State Fullerton,3,1,Utah,2
2021-02-21,@Cal State Fullerton,15,1,Utah,14
2021-02-22,@Cal State Fullerton,5,6,Utah,-1
2021-02-26,@San Diego,1,6,San Diego,-5
2021-02-27,@San Diego,5,6,San Diego,-1
2021-02-28,@San Diego,5,1,San Diego,4
2021-03-02,@UCLA,1,14,UCLA,-13
2021-03-05,@Southern California,5,0,Southern California,5
2021-03-06,@UCLA,1,6,UCLA,-5
2021-03-07,@Cal State Fullerton,4,10,Pepperdine,-6
2021-03-09,@Cal State Fullerton,2,6,UCLA,-4
2021-03-12,@Arizona State,0,10,Arizona State,-10
2021-03-13,@Arizona State,4,6,Arizona State,-2
2021-03-14,@Arizona State,2,5,Arizona State,-3
2021-03-19,@Cal State Fullerton,2,9,UC Santa Barbara,-7
2021-03-20,@Cal State Fullerton,4,11,UC Santa Barbara,-7
2021-03-20,@Cal State Fullerton,4,1,UC Santa Barbara,3
2021-03-21,@Cal State Fullerton,10,9,UC Santa Barbara,1
2021-03-26,@UC Riverside,4,3,UC Riverside,1
2021-03-27,@UC Riverside,5,7,UC Riverside,-2
2021-03-27,@UC Riverside,18,6,UC Riverside,12
2021-03-28,@UC Riverside,16,8,UC Riverside,8
2021-04-02,@Cal State Fullerton,3,1,San Diego,2
2021-04-03,@San Diego,2,8,San Diego,-6
2021-04-09,@Cal State Fullerton,8,3,California Baptist,5
2021-04-10,@Cal State Fullerton,6,3,California Baptist,3
2021-04-11,@Cal State Fullerton,7,9,California Baptist,-2
2021-04-16,@UC Davis,9,3,UC Davis,6
2021-04-17,@UC Davis,2,1,UC Davis,1
2021-04-17,@UC Davis,7,9,UC Davis,-2
2021-04-18,@UC Davis,7,6,UC Davis,1
2021-04-23,@Cal State Northridge,1,11,Cal State Northridge,-10
2021-04-24,@Cal State Northridge,6,4,Cal State Northridge,2
2021-04-24,@Cal State Northridge,2,10,Cal State Northridge,-8
2021-04-25,@Cal State Northridge,6,5,Cal State Northridge,1
2021-04-30,@Cal State Fullerton,5,4,Hawaii,1
2021-05-01,@Cal State Fullerton,8,16,Hawaii,-8
2021-05-01,@Cal State Fullerton,1,4,Hawaii,-3
2021-05-02,@Cal State Fullerton,2,8,Hawaii,-6
2021-05-07,@Cal State Fullerton,6,3,UC San Diego,3
2021-05-08,@Cal State Fullerton,5,7,UC San Diego,-2
2021-05-08,@Cal State Fullerton,2,5,UC San Diego,-3
2021-05-09,@Cal State Fullerton,1,6,UC San Diego,-5
2021-05-14,@Cal Poly,1,5,Cal Poly,-4
2021-05-15,@Cal Poly,0,10,Cal Poly,-10
2021-05-15,@Cal Poly,3,13,Cal Poly,-10
2021-05-16,@Cal Poly,1,9,Cal Poly,-8
2021-05-21,@Cal State Fullerton,1,9,Long Beach State,-8
2021-05-22,@Cal State Fullerton,4,14,Long Beach State,-10
2021-05-22,@Cal State Fullerton,11,3,Long Beach State,8
2021-05-23,@Cal State Fullerton,1,4,Long Beach State,-3
2021-05-28,@UC Irvine,4,10,UC Irvine,-6
2021-05-29,@UC Irvine,0,7,UC Irvine,-7
2021-05-29,@UC Irvine,5,9,UC Irvine,-4
2021-05-30,@UC Irvine,2,4,UC Irvine,-2
2021-03-20,@Cal State Northridge,13,10,Cal Poly,3
2021-03-21,@Cal State Northridge,6,7,Cal Poly,-1
2021-03-21,@Cal State Northridge,1,12,Cal Poly,-11
2021-03-22,@Cal State Northridge,8,10,Cal Poly,-2
2021-03-26,@Long Beach State,3,1,Long Beach State,2
2021-03-27,@Long Beach State,5,10,Long Beach State,-5
2021-03-27,@Long Beach State,3,7,Long Beach State,-4
2021-03-28,@Long Beach State,6,1,Long Beach State,5
2021-04-03,@Cal State Northridge,8,7,UC Irvine,1
2021-04-03,@Cal State Northridge,3,17,UC Irvine,-14
2021-04-04,@Cal State Northridge,9,6,UC Irvine,3
2021-04-04,@Cal State Northridge,3,20,UC Irvine,-17
2021-04-09,@UC Santa Barbara,4,5,UC Santa Barbara,-1
2021-04-10,@UC Santa Barbara,1,11,UC Santa Barbara,-10
2021-04-10,@UC Santa Barbara,3,11,UC Santa Barbara,-8
2021-04-11,@UC Santa Barbara,7,3,UC Santa Barbara,4
2021-04-16,@Cal State Northridge,5,6,UC Riverside,-1
2021-04-17,@Cal State Northridge,1,5,UC Riverside,-4
2021-04-17,@Cal State Northridge,4,8,UC Riverside,-4
2021-04-18,@Cal State Northridge,15,8,UC Riverside,7
2021-04-23,@Cal State Northridge,11,1,Cal State Fullerton,10
2021-04-24,@Cal State Northridge,4,6,Cal State Fullerton,-2
2021-04-24,@Cal State Northridge,10,2,Cal State Fullerton,8
2021-04-25,@Cal State Northridge,5,6,Cal State Fullerton,-1
2021-04-30,@CSU Bakersfield,9,4,CSU Bakersfield,5
2021-05-01,@CSU Bakersfield,8,5,CSU Bakersfield,3
2021-05-01,@CSU Bakersfield,10,2,CSU Bakersfield,8
2021-05-02,@CSU Bakersfield,5,1,CSU Bakersfield,4
2021-05-07,@UC Davis,10,6,UC Davis,4
2021-05-08,@UC Davis,9,13,UC Davis,-4
2021-05-08,@UC Davis,11,5,UC Davis,6
2021-05-09,@UC Davis,8,3,UC Davis,5
2021-05-14,@Cal State Northridge,9,1,Hawaii,8
2021-05-15,@Cal State Northridge,4,3,Hawaii,1
2021-05-15,@Cal State Northridge,12,0,Hawaii,12
2021-05-16,@Cal State Northridge,6,4,Hawaii,2
2021-05-27,@UC San Diego,1,3,UC San Diego,-2
2021-05-28,@UC San Diego,2,5,UC San Diego,-3
2021-05-28,@UC San Diego,2,0,UC San Diego,2
2021-05-29,@UC San Diego,4,5,UC San Diego,-1
2021-02-19,@California,4,3,Pacific,1
2021-02-20,@California,3,6,Pacific,-3
2021-02-21,@Pacific,2,5,Pacific,-3
2021-02-22,@Pacific,6,7,Pacific,-1
2021-02-25,@California,4,2,San Francisco,2
2021-02-26,@California,4,3,San Francisco,1
2021-02-27,@San Francisco,6,10,San Francisco,-4
2021-02-28,@San Francisco,5,1,San Francisco,4
2021-03-04,@California,16,3,St. Mary's,13
2021-03-05,@California,2,1,St. Mary's,1
2021-03-06,@St. Mary's,4,2,St. Mary's,2
2021-03-07,@St. Mary's,3,8,St. Mary's,-5
2021-03-12,@California,3,4,Loyola Marymount,-1
2021-03-13,@California,6,4,Loyola Marymount,2
2021-03-13,@California,11,5,Loyola Marymount,6
2021-03-14,@California,7,1,Loyola Marymount,6
2021-03-19,@California,0,7,California Baptist,-7
2021-03-20,@California,15,1,California Baptist,14
2021-03-21,@California,9,8,California Baptist,1
2021-03-26,@Utah,9,0,Utah,9
2021-03-27,@Utah,9,5,Utah,4
2021-03-28,@Utah,4,11,Utah,-7
2021-03-30,@San Jose State,7,10,San Jose State,-3
2021-04-01,@California,1,6,Southern California,-5
2021-04-02,@California,4,3,Southern California,1
2021-04-03,@California,5,1,Southern California,4
2021-04-06,@Stanford,3,4,Stanford,-1
2021-04-09,@Arizona,1,5,Arizona,-4
2021-04-10,@Arizona,3,4,Arizona,-1
2021-04-11,@Arizona,9,1,Arizona,8
2021-04-13,@St. Mary's,3,2,St. Mary's,1
2021-04-16,@Oregon State,8,15,Oregon State,-7
2021-04-17,@Oregon State,1,2,Oregon State,-1
2021-04-18,@Oregon State,3,5,Oregon State,-2
2021-04-21,@California,3,6,St. Mary's,-3
2021-04-23,@California,3,2,Washington State,1
2021-04-24,@California,2,4,Washington State,-2
2021-04-25,@California,3,4,Washington State,-1
2021-04-30,@Washington,9,0,Washington,9
2021-05-01,@Washington,5,1,Washington,4
2021-05-02,@Washington,3,2,Washington,1
2021-05-04,@California,18,10,San Jose State,8
2021-05-07,@California,7,2,Arizona State,5
2021-05-08,@California,3,6,Arizona State,-3
2021-05-09,@California,2,7,Arizona State,-5
2021-05-14,@California,2,9,Stanford,-7
2021-05-15,@California,5,4,Stanford,1
2021-05-16,@California,9,5,Stanford,4
2021-05-17,@Stanford,6,7,Stanford,-1
2021-05-21,@UCLA,14,2,UCLA,12
2021-05-22,@UCLA,4,2,UCLA,2
2021-05-23,@UCLA,4,7,UCLA,-3
2021-05-27,@California,5,11,Oregon,-6
2021-05-28,@California,10,3,Oregon,7
2021-05-29,@California,5,6,Oregon,-1
2021-02-19,@California Baptist,9,1,Pepperdine,8
2021-02-20,@Pepperdine,6,10,Pepperdine,-4
2021-02-21,@California Baptist,6,2,Pepperdine,4
2021-02-26,@California Baptist,1,5,St. Mary's,-4
2021-02-27,@California Baptist,0,6,St. Mary's,-6
2021-02-27,@California Baptist,4,8,St. Mary's,-4
2021-02-28,@California Baptist,8,5,St. Mary's,3
2021-03-05,@UC Davis,6,1,UC Davis,5
2021-03-06,@UC Davis,5,4,UC Davis,1
2021-03-07,@UC Davis,6,5,UC Davis,1
2021-03-13,@California Baptist,7,3,Northern Colorado,4
2021-03-13,@California Baptist,4,3,Northern Colorado,1
2021-03-14,@California Baptist,2,1,Northern Colorado,1
2021-03-14,@California Baptist,7,4,Northern Colorado,3
2021-03-19,@California,7,0,California,7
2021-03-20,@California,1,15,California,-14
2021-03-21,@California,8,9,California,-1
2021-03-26,@California Baptist,6,2,Tarleton State,4
2021-03-27,@California Baptist,6,3,Tarleton State,3
2021-03-27,@California Baptist,7,3,Tarleton State,4
2021-03-28,@California Baptist,3,1,Tarleton State,2
2021-04-01,@Texas-Rio Grande Valley,3,0,Texas-Rio Grande Valley,3
2021-04-02,@Texas-Rio Grande Valley,3,2,Texas-Rio Grande Valley,1
2021-04-02,@Texas-Rio Grande Valley,3,2,Texas-Rio Grande Valley,1
2021-04-03,@Texas-Rio Grande Valley,3,4,Texas-Rio Grande Valley,-1
2021-04-09,@Cal State Fullerton,3,8,Cal State Fullerton,-5
2021-04-10,@Cal State Fullerton,3,6,Cal State Fullerton,-3
2021-04-11,@Cal State Fullerton,9,7,Cal State Fullerton,2
2021-04-16,@Dixie State,1,3,Dixie State,-2
2021-04-17,@Dixie State,1,2,Dixie State,-1
2021-04-17,@Dixie State,7,4,Dixie State,3
2021-04-18,@Dixie State,14,8,Dixie State,6
2021-04-23,@California Baptist,10,0,Utah Valley,10
2021-04-24,@California Baptist,7,3,Utah Valley,4
2021-04-24,@California Baptist,11,7,Utah Valley,4
2021-04-25,@California Baptist,6,2,Utah Valley,4
2021-04-30,@Seattle,9,1,Seattle,8
2021-05-01,@Seattle,7,4,Seattle,3
2021-05-01,@Seattle,6,1,Seattle,5
2021-05-02,@Seattle,9,1,Seattle,8
2021-05-07,@California Baptist,11,14,Sacramento State,-3
2021-05-08,@California Baptist,7,6,Sacramento State,1
2021-05-08,@California Baptist,6,1,Sacramento State,5
2021-05-09,@California Baptist,1,14,Sacramento State,-13
2021-05-14,@New Mexico State,10,4,New Mexico State,6
2021-05-15,@New Mexico State,4,2,New Mexico State,2
2021-05-15,@New Mexico State,11,6,New Mexico State,5
2021-05-16,@New Mexico State,17,7,New Mexico State,10
2021-05-20,@Grand Canyon,1,5,Grand Canyon,-4
2021-05-21,@Grand Canyon,5,3,Grand Canyon,2
2021-05-21,@Grand Canyon,1,2,Grand Canyon,-1
2021-05-22,@Grand Canyon,6,1,Grand Canyon,5
2021-05-27,@UC Riverside,5,4,UC Riverside,1
2021-05-28,@California Baptist,7,4,UC Riverside,3
2021-05-28,@California Baptist,6,12,UC Riverside,-6
2021-05-29,@UC Riverside,14,6,UC Riverside,8
2021-02-19,@Campbell,1,4,Liberty,-3
2021-02-20,@Campbell,17,3,Liberty,14
2021-02-21,@Campbell,3,2,Liberty,1
2021-02-26,@Campbell,8,1,Dayton,7
2021-02-27,@Campbell,4,5,Dayton,-1
2021-02-28,@Campbell,11,2,Dayton,9
2021-03-02,@North Carolina State,6,14,North Carolina State,-8
2021-03-05,@Campbell,2,6,Gardner-Webb,-4
2021-03-06,@Campbell,7,3,Gardner-Webb,4
2021-03-06,@Campbell,14,6,Gardner-Webb,8
2021-03-09,@Campbell,3,2,College of Charleston,1
2021-03-12,@Campbell,1,6,South Carolina-Upstate,-5
2021-03-13,@Campbell,4,2,South Carolina-Upstate,2
2021-03-13,@Campbell,4,3,South Carolina-Upstate,1
2021-03-20,@North Carolina-Asheville,6,8,North Carolina-Asheville,-2
2021-03-20,@North Carolina-Asheville,17,4,North Carolina-Asheville,13
2021-03-21,@North Carolina-Asheville,2,4,North Carolina-Asheville,-2
2021-03-23,@High Point,4,9,High Point,-5
2021-04-02,@Campbell,6,5,Winthrop,1
2021-04-02,@Campbell,8,1,Winthrop,7
2021-04-03,@Campbell,15,6,Winthrop,9
2021-04-06,@Winthrop,28,11,Winthrop,17
2021-04-09,@Campbell,6,10,Charleston Southern,-4
2021-04-10,@Campbell,7,2,Charleston Southern,5
2021-04-10,@Campbell,12,2,Charleston Southern,10
2021-04-13,@Duke,7,14,Duke,-7
2021-04-16,@Gardner-Webb,10,6,Gardner-Webb,4
2021-04-17,@Gardner-Webb,10,1,Gardner-Webb,9
2021-04-17,@Gardner-Webb,8,10,Gardner-Webb,-2
2021-04-20,@Campbell,16,8,High Point,8
2021-04-23,@Presbyterian,6,7,Presbyterian,-1
2021-04-25,@Presbyterian,21,5,Presbyterian,16
2021-04-25,@Presbyterian,6,12,Presbyterian,-6
2021-04-30,@Campbell,19,1,North Carolina-Asheville,18
2021-05-01,@Campbell,9,1,North Carolina-Asheville,8
2021-05-01,@Campbell,12,2,North Carolina-Asheville,10
2021-05-05,@North Carolina,3,9,North Carolina,-6
2021-05-07,@Radford,12,6,Radford,6
2021-05-08,@Radford,6,1,Radford,5
2021-05-08,@Radford,10,4,Radford,6
2021-05-11,@Campbell,12,3,Winthrop,9
2021-05-14,@South Carolina-Upstate,6,5,South Carolina-Upstate,1
2021-05-15,@South Carolina-Upstate,8,0,South Carolina-Upstate,8
2021-05-15,@South Carolina-Upstate,12,0,South Carolina-Upstate,12
2021-05-20,@Campbell,13,3,High Point,10
2021-05-21,@Campbell,8,5,High Point,3
2021-05-21,@Campbell,7,4,High Point,3
2021-05-27,@Campbell,2,7,Presbyterian,-5
2021-05-28,@Campbell,5,3,South Carolina-Upstate,2
2021-05-28,@Campbell,13,9,Gardner-Webb,4
2021-05-29,@Campbell,5,8,Presbyterian,-3
2021-06-04,@Virginia Commonwealth,4,19,Virginia Commonwealth,-15
2021-06-05,@Campbell,16,13,Samford,3
2021-06-06,@Campbell,19,10,Virginia Commonwealth,9
2021-06-07,@Campbell,5,6,Mississippi State,-1
2021-03-20,@Fairfield,4,7,Fairfield,-3
2021-03-20,@Fairfield,4,13,Fairfield,-9
2021-03-21,@Fairfield,0,8,Fairfield,-8
2021-03-21,@Fairfield,3,6,Fairfield,-3
2021-03-27,@Iona,5,3,Iona,2
2021-03-27,@Iona,8,5,Iona,3
2021-03-28,@Iona,5,0,Iona,5
2021-03-28,@Iona,6,8,Iona,-2
2021-04-07,@Niagara,6,3,Niagara,3
2021-04-07,@Niagara,3,4,Niagara,-1
2021-04-10,@Canisius,7,2,Manhattan,5
2021-04-10,@Canisius,10,3,Manhattan,7
2021-04-11,@Canisius,13,2,Manhattan,11
2021-04-11,@Canisius,4,2,Manhattan,2
2021-04-14,@Niagara,20,2,Niagara,18
2021-04-14,@Niagara,2,3,Niagara,-1
2021-04-25,@Canisius,8,0,Rider,8
2021-04-25,@Canisius,3,4,Rider,-1
2021-04-26,@Canisius,2,5,Rider,-3
2021-04-26,@Canisius,5,4,Rider,1
2021-05-09,@Canisius,5,1,Quinnipiac,4
2021-05-10,@Canisius,15,5,Quinnipiac,10
2021-05-10,@Canisius,10,2,Quinnipiac,8
2021-05-10,@Canisius,1,2,Quinnipiac,-1
2021-05-12,@Canisius,21,0,St. Peter's,21
2021-05-12,@Canisius,20,11,St. Peter's,9
2021-05-15,@Monmouth,5,8,Monmouth,-3
2021-05-15,@Monmouth,11,12,Monmouth,-1
2021-05-16,@Monmouth,4,7,Monmouth,-3
2021-05-16,@Monmouth,7,1,Monmouth,6
2021-05-20,@Canisius,6,12,Marist,-6
2021-05-20,@Canisius,8,3,Marist,5
2021-05-21,@Canisius,10,7,Marist,3
2021-05-26,@Fairfield,4,1,Fairfield,3
2021-05-27,@Rider,3,4,Rider,-1
2021-05-28,@Fairfield,2,8,Fairfield,-6
2021-02-26,@Missouri State,1,6,Missouri State,-5
2021-02-27,@Missouri State,5,2,Missouri State,3
2021-02-28,@Missouri State,2,12,Missouri State,-10
2021-03-03,@Arkansas-Little Rock,3,5,Arkansas-Little Rock,-2
2021-03-05,@Central Arkansas,6,1,Tarleton State,5
2021-03-06,@Central Arkansas,19,2,Tarleton State,17
2021-03-07,@Central Arkansas,9,15,Missouri State,-6
2021-03-12,@Central Arkansas,8,9,Abilene Christian,-1
2021-03-13,@Central Arkansas,4,5,Abilene Christian,-1
2021-03-13,@Central Arkansas,6,3,Abilene Christian,3
2021-03-14,@Central Arkansas,9,8,Abilene Christian,1
2021-03-19,@Lamar,5,7,Lamar,-2
2021-03-20,@Lamar,2,7,Lamar,-5
2021-03-20,@Lamar,5,2,Lamar,3
2021-03-21,@Lamar,6,1,Lamar,5
2021-03-23,@Mississippi,2,5,Mississippi,-3
2021-03-26,@Incarnate Word,12,7,Incarnate Word,5
2021-03-27,@Incarnate Word,2,10,Incarnate Word,-8
2021-03-27,@Incarnate Word,11,12,Incarnate Word,-1
2021-03-28,@Incarnate Word,4,3,Incarnate Word,1
2021-03-30,@Arkansas,8,21,Arkansas,-13
2021-04-01,@Central Arkansas,2,3,Sam Houston State,-1
2021-04-02,@Central Arkansas,0,2,Sam Houston State,-2
2021-04-02,@Central Arkansas,1,3,Sam Houston State,-2
2021-04-03,@Central Arkansas,4,10,Sam Houston State,-6
2021-04-13,@Central Arkansas,4,2,Arkansas-Little Rock,2
2021-04-16,@Texas A&M-Corpus Christi,4,7,Texas A&M-Corpus Christi,-3
2021-04-17,@Texas A&M-Corpus Christi,1,2,Texas A&M-Corpus Christi,-1
2021-04-18,@Texas A&M-Corpus Christi,4,10,Texas A&M-Corpus Christi,-6
2021-04-18,@Texas A&M-Corpus Christi,1,5,Texas A&M-Corpus Christi,-4
2021-04-20,@Central Arkansas,5,3,Arkansas State,2
2021-04-23,@Central Arkansas,10,9,Stephen F. Austin State,1
2021-04-24,@Central Arkansas,2,8,Stephen F. Austin State,-6
2021-04-25,@Central Arkansas,9,0,Stephen F. Austin State,9
2021-04-25,@Central Arkansas,7,6,Stephen F. Austin State,1
2021-04-30,@Central Arkansas,3,1,Northwestern State,2
2021-04-30,@Central Arkansas,4,8,Northwestern State,-4
2021-05-01,@Central Arkansas,9,2,Northwestern State,7
2021-05-01,@Central Arkansas,13,8,Northwestern State,5
2021-05-07,@New Orleans,15,5,New Orleans,10
2021-05-08,@New Orleans,8,0,New Orleans,8
2021-05-08,@New Orleans,0,11,New Orleans,-11
2021-05-09,@New Orleans,3,4,New Orleans,-1
2021-05-14,@Houston Baptist,8,6,Houston Baptist,2
2021-05-14,@Houston Baptist,1,7,Houston Baptist,-6
2021-05-15,@Houston Baptist,3,2,Houston Baptist,1
2021-05-15,@Houston Baptist,6,8,Houston Baptist,-2
2021-05-20,@Central Arkansas,8,1,McNeese State,7
2021-05-21,@Central Arkansas,5,6,McNeese State,-1
2021-05-21,@Central Arkansas,1,6,McNeese State,-5
2021-05-22,@Central Arkansas,5,4,McNeese State,1
2021-03-07,@Central Connecticut State,15,6,Albany,9
2021-03-09,@Central Connecticut State,8,6,Massachusetts,2
2021-03-12,@Central Connecticut State,3,4,Stony Brook,-1
2021-03-13,@Central Connecticut State,3,9,Stony Brook,-6
2021-03-14,@Central Connecticut State,4,1,Stony Brook,3
2021-03-19,@Central Connecticut State,6,0,Sacred Heart,6
2021-03-20,@Central Connecticut State,4,2,Sacred Heart,2
2021-03-21,@Central Connecticut State,2,3,Sacred Heart,-1
2021-03-23,@Connecticut,0,2,Connecticut,-2
2021-03-26,@Fairleigh Dickinson,21,7,Fairleigh Dickinson,14
2021-03-27,@Fairleigh Dickinson,9,5,Fairleigh Dickinson,4
2021-03-27,@Fairleigh Dickinson,2,5,Fairleigh Dickinson,-3
2021-04-01,@Central Connecticut State,6,2,Mount St. Mary's,4
2021-04-02,@Central Connecticut State,5,1,Mount St. Mary's,4
2021-04-03,@Central Connecticut State,5,3,Mount St. Mary's,2
2021-04-09,@Central Connecticut State,10,14,Merrimack,-4
2021-04-10,@Central Connecticut State,11,3,Merrimack,8
2021-04-10,@Central Connecticut State,6,3,Merrimack,3
2021-04-16,@LIU-Brooklyn,4,2,LIU-Brooklyn,2
2021-04-17,@LIU-Brooklyn,10,1,LIU-Brooklyn,9
2021-04-18,@LIU-Brooklyn,4,5,LIU-Brooklyn,-1
2021-04-23,@Central Connecticut State,2,4,Bryant,-2
2021-04-24,@Central Connecticut State,13,5,Bryant,8
2021-04-24,@Central Connecticut State,6,8,Bryant,-2
2021-04-30,@Wagner,6,2,Wagner,4
2021-05-01,@Wagner,9,3,Wagner,6
2021-05-02,@Wagner,6,3,Wagner,3
2021-05-07,@Sacred Heart,11,3,Sacred Heart,8
2021-05-08,@Sacred Heart,3,4,Sacred Heart,-1
2021-05-09,@Sacred Heart,1,2,Sacred Heart,-1
2021-05-13,@Mount St. Mary's,8,2,Mount St. Mary's,6
2021-05-14,@Mount St. Mary's,5,2,Mount St. Mary's,3
2021-05-15,@Mount St. Mary's,8,7,Mount St. Mary's,1
2021-05-20,@Central Connecticut State,6,0,Fairleigh Dickinson,6
2021-05-21,@Central Connecticut State,14,12,Fairleigh Dickinson,2
2021-05-21,@Central Connecticut State,1,3,Fairleigh Dickinson,-2
2021-05-27,@Central Connecticut State,17,10,Sacred Heart,7
2021-05-28,@Bryant,0,6,Bryant,-6
2021-05-29,@Central Connecticut State,7,5,Bryant,2
2021-05-29,@Sacred Heart,5,3,Sacred Heart,2
2021-05-30,@Central Connecticut State,5,2,Bryant,3
2021-06-04,@Oregon,10,13,Oregon,-3
2021-06-05,@Louisiana State,5,6,Louisiana State,-1
2021-02-19,@Central Florida,6,12,Florida Atlantic,-6
2021-02-20,@Florida Atlantic,15,20,Florida Atlantic,-5
2021-02-21,@Florida Atlantic,15,6,Florida Atlantic,9
2021-02-23,@Central Florida,0,7,Stetson,-7
2021-02-26,@Mississippi,3,2,Mississippi,1
2021-02-27,@Mississippi,5,6,Mississippi,-1
2021-02-27,@Mississippi,7,2,Mississippi,5
2021-03-03,@Stetson,5,6,Stetson,-1
2021-03-05,@Central Florida,1,2,Liberty,-1
2021-03-05,@Central Florida,3,8,Liberty,-5
2021-03-07,@Central Florida,2,3,Liberty,-1
2021-03-10,@North Florida,10,0,North Florida,10
2021-03-12,@Central Florida,6,2,North Florida,4
2021-03-13,@North Florida,7,14,North Florida,-7
2021-03-14,@Central Florida,3,2,North Florida,1
2021-03-16,@Central Florida,8,3,Florida Atlantic,5
2021-03-19,@Jacksonville,1,2,Jacksonville,-1
2021-03-20,@Jacksonville,12,9,Jacksonville,3
2021-03-21,@Central Florida,10,0,Jacksonville,10
2021-03-24,@Florida State,5,6,Florida State,-1
2021-03-26,@Troy,6,3,Troy,3
2021-03-27,@Troy,1,2,Troy,-1
2021-03-28,@Troy,12,14,Troy,-2
2021-03-30,@Central Florida,6,11,Jacksonville,-5
2021-04-01,@South Florida,5,2,South Florida,3
2021-04-02,@South Florida,1,3,South Florida,-2
2021-04-02,@South Florida,2,6,South Florida,-4
2021-04-03,@South Florida,3,0,South Florida,3
2021-04-09,@Cincinnati,1,2,Cincinnati,-1
2021-04-09,@Cincinnati,8,6,Cincinnati,2
2021-04-10,@Cincinnati,20,10,Cincinnati,10
2021-04-11,@Cincinnati,6,10,Cincinnati,-4
2021-04-16,@Central Florida,5,2,South Florida,3
2021-04-16,@Central Florida,6,0,South Florida,6
2021-04-17,@Central Florida,0,11,South Florida,-11
2021-04-17,@Central Florida,5,4,South Florida,1
2021-04-23,@East Carolina,10,5,East Carolina,5
2021-04-23,@East Carolina,2,4,East Carolina,-2
2021-04-24,@East Carolina,8,11,East Carolina,-3
2021-04-25,@East Carolina,6,1,East Carolina,5
2021-04-30,@Central Florida,12,10,Memphis,2
2021-04-30,@Central Florida,2,12,Memphis,-10
2021-05-01,@Central Florida,13,6,Memphis,7
2021-05-02,@Central Florida,17,5,Memphis,12
2021-05-07,@Central Florida,6,3,Wichita State,3
2021-05-07,@Central Florida,1,11,Wichita State,-10
2021-05-08,@Central Florida,3,10,Wichita State,-7
2021-05-09,@Central Florida,6,7,Wichita State,-1
2021-05-14,@Tulane,1,9,Tulane,-8
2021-05-14,@Tulane,4,5,Tulane,-1
2021-05-15,@Tulane,6,4,Tulane,2
2021-05-16,@Tulane,7,14,Tulane,-7
2021-05-20,@Central Florida,3,1,Houston,2
2021-05-20,@Central Florida,2,1,Houston,1
2021-05-21,@Central Florida,6,0,Houston,6
2021-05-22,@Central Florida,2,1,Houston,1
2021-05-25,@Cincinnati,14,10,Cincinnati,4
2021-05-27,@Central Florida,17,1,Memphis,16
2021-05-29,@East Carolina,2,1,East Carolina,1
2021-05-29,@East Carolina,2,5,East Carolina,-3
2021-05-30,@Central Florida,7,8,South Florida,-1
2021-02-21,@Texas A&M-Corpus Christi,3,4,Texas A&M-Corpus Christi,-1
2021-02-21,@Texas A&M-Corpus Christi,1,5,Texas A&M-Corpus Christi,-4
2021-02-22,@Texas A&M-Corpus Christi,3,6,Texas A&M-Corpus Christi,-3
2021-03-06,@Virginia Commonwealth,11,12,Virginia Commonwealth,-1
2021-03-07,@William and Mary,12,1,William and Mary,11
2021-03-07,@William and Mary,7,3,William and Mary,4
2021-03-08,@Richmond,10,2,Richmond,8
2021-03-12,@West Virginia,5,3,West Virginia,2
2021-03-13,@West Virginia,7,8,West Virginia,-1
2021-03-13,@West Virginia,12,4,West Virginia,8
2021-03-19,@Dayton,1,3,Dayton,-2
2021-03-20,@Dayton,13,3,Dayton,10
2021-03-20,@Dayton,5,4,Dayton,1
2021-03-21,@Dayton,15,4,Dayton,11
2021-03-26,@Ohio,1,5,Ohio,-4
2021-03-27,@Ohio,3,4,Ohio,-1
2021-03-27,@Ohio,12,2,Ohio,10
2021-03-28,@Ohio,14,3,Ohio,11
2021-04-02,@Northern Illinois,11,0,Northern Illinois,11
2021-04-03,@Northern Illinois,2,1,Northern Illinois,1
2021-04-03,@Northern Illinois,17,6,Northern Illinois,11
2021-04-04,@Northern Illinois,12,10,Northern Illinois,2
2021-04-10,@Central Michigan,2,3,Bowling Green State,-1
2021-04-10,@Central Michigan,1,0,Bowling Green State,1
2021-04-11,@Central Michigan,5,1,Bowling Green State,4
2021-04-11,@Central Michigan,13,4,Bowling Green State,9
2021-04-13,@Notre Dame,4,8,Notre Dame,-4
2021-04-16,@Central Michigan,10,0,Kent State,10
2021-04-17,@Central Michigan,2,1,Kent State,1
2021-04-17,@Central Michigan,3,1,Kent State,2
2021-04-18,@Central Michigan,4,6,Kent State,-2
2021-04-23,@Akron,13,1,Akron,12
2021-04-24,@Akron,12,0,Akron,12
2021-04-24,@Akron,3,2,Akron,1
2021-04-25,@Akron,15,2,Akron,13
2021-04-30,@Central Michigan,14,0,"Miami, Ohio",14
2021-05-01,@Central Michigan,6,3,"Miami, Ohio",3
2021-05-01,@Central Michigan,2,1,"Miami, Ohio",1
2021-05-02,@Central Michigan,3,1,"Miami, Ohio",2
2021-05-07,@Central Michigan,7,3,Ball State,4
2021-05-08,@Central Michigan,3,13,Ball State,-10
2021-05-08,@Central Michigan,3,2,Ball State,1
2021-05-09,@Central Michigan,7,8,Ball State,-1
2021-05-11,@Central Michigan,5,1,Northwood,4
2021-05-14,@Western Michigan,3,8,Western Michigan,-5
2021-05-15,@Western Michigan,11,0,Western Michigan,11
2021-05-15,@Western Michigan,3,10,Western Michigan,-7
2021-05-16,@Western Michigan,1,6,Western Michigan,-5
2021-05-21,@Central Michigan,14,0,Eastern Michigan,14
2021-05-22,@Central Michigan,4,2,Eastern Michigan,2
2021-05-22,@Central Michigan,1,0,Eastern Michigan,1
2021-05-23,@Central Michigan,8,4,Eastern Michigan,4
2021-05-29,@Toledo,9,0,Toledo,9
2021-05-29,@Toledo,1,0,Toledo,1
2021-05-30,@Toledo,5,4,Toledo,1
2021-05-30,@Toledo,10,1,Toledo,9
2021-06-04,@Notre Dame,0,10,Notre Dame,-10
2021-06-05,@Central Michigan,8,2,Michigan,6
2021-06-06,@Central Michigan,14,9,Connecticut,5
2021-06-06,@Notre Dame,2,14,Notre Dame,-12
2021-02-20,@Charleston Southern,4,12,Boston College,-8
2021-02-20,@Charleston Southern,1,12,Boston College,-11
2021-02-21,@Charleston Southern,2,10,Boston College,-8
2021-03-05,@Charleston Southern,7,0,Longwood,7
2021-03-06,@Charleston Southern,8,10,Longwood,-2
2021-03-06,@Charleston Southern,6,5,Longwood,1
2021-03-12,@Charleston Southern,3,15,North Carolina-Asheville,-12
2021-03-13,@Charleston Southern,15,5,North Carolina-Asheville,10
2021-03-13,@Charleston Southern,9,1,North Carolina-Asheville,8
2021-03-16,@Presbyterian,8,2,Presbyterian,6
2021-03-20,@Gardner-Webb,5,1,Gardner-Webb,4
2021-03-20,@Gardner-Webb,5,6,Gardner-Webb,-1
2021-03-21,@Gardner-Webb,7,4,Gardner-Webb,3
2021-03-23,@Winthrop,1,4,Winthrop,-3
2021-03-26,@Presbyterian,1,2,Presbyterian,-1
2021-03-27,@Presbyterian,1,3,Presbyterian,-2
2021-03-27,@Presbyterian,0,3,Presbyterian,-3
2021-04-01,@Charleston Southern,5,10,High Point,-5
2021-04-02,@Charleston Southern,15,4,High Point,11
2021-04-02,@Charleston Southern,10,7,High Point,3
2021-04-09,@Campbell,10,6,Campbell,4
2021-04-10,@Campbell,2,12,Campbell,-10
2021-04-10,@Campbell,2,7,Campbell,-5
2021-04-13,@South Carolina,0,9,South Carolina,-9
2021-04-16,@Charleston Southern,0,2,South Carolina-Upstate,-2
2021-04-17,@Charleston Southern,6,0,South Carolina-Upstate,6
2021-04-17,@Charleston Southern,5,4,South Carolina-Upstate,1
2021-04-20,@Charleston Southern,5,13,Winthrop,-8
2021-04-22,@North Carolina-Asheville,13,1,North Carolina-Asheville,12
2021-04-23,@North Carolina-Asheville,2,17,North Carolina-Asheville,-15
2021-04-23,@North Carolina-Asheville,2,4,North Carolina-Asheville,-2
2021-04-30,@Charleston Southern,4,5,Gardner-Webb,-1
2021-05-01,@Charleston Southern,6,10,Gardner-Webb,-4
2021-05-01,@Charleston Southern,7,1,Gardner-Webb,6
2021-05-07,@Charleston Southern,2,4,Winthrop,-2
2021-05-08,@Charleston Southern,4,17,Winthrop,-13
2021-05-08,@Charleston Southern,7,9,Winthrop,-2
2021-05-11,@Charleston Southern,9,8,Presbyterian,1
2021-05-14,@Radford,6,14,Radford,-8
2021-05-15,@Radford,3,11,Radford,-8
2021-05-15,@Radford,3,6,Radford,-3
2021-05-20,@Longwood,6,4,Longwood,2
2021-05-20,@Longwood,10,8,Longwood,2
2021-05-21,@Longwood,13,2,Longwood,11
2021-02-19,@Clemson,0,5,Clemson,-5
2021-02-20,@Clemson,2,5,Clemson,-3
2021-02-21,@Clemson,7,8,Clemson,-1
2021-02-26,@Western Kentucky,4,5,Western Kentucky,-1
2021-02-27,@Western Kentucky,4,5,Western Kentucky,-1
2021-02-27,@Western Kentucky,11,3,Western Kentucky,8
2021-03-04,@North Carolina-Wilmington,10,14,North Carolina-Wilmington,-4
2021-03-05,@North Carolina-Wilmington,7,4,North Carolina-Wilmington,3
2021-03-06,@North Carolina-Wilmington,5,4,North Carolina-Wilmington,1
2021-03-07,@North Carolina-Wilmington,8,9,North Carolina-Wilmington,-1
2021-03-12,@Cincinnati,5,1,Western Michigan,4
2021-03-13,@Cincinnati,7,5,Western Michigan,2
2021-03-14,@Cincinnati,5,4,Western Michigan,1
2021-03-19,@Cincinnati,1,2,Xavier,-1
2021-03-20,@Xavier,22,7,Xavier,15
2021-03-21,@Xavier,8,16,Xavier,-8
2021-03-22,@Cincinnati,7,2,Xavier,5
2021-03-26,@Cincinnati,8,4,St. Louis,4
2021-03-27,@Cincinnati,8,5,St. Louis,3
2021-03-28,@Cincinnati,6,21,St. Louis,-15
2021-03-30,@Cincinnati,13,12,Louisville,1
2021-04-01,@East Carolina,4,5,East Carolina,-1
2021-04-02,@East Carolina,0,7,East Carolina,-7
2021-04-03,@East Carolina,0,2,East Carolina,-2
2021-04-03,@East Carolina,3,13,East Carolina,-10
2021-04-09,@Cincinnati,6,8,Central Florida,-2
2021-04-09,@Cincinnati,2,1,Central Florida,1
2021-04-10,@Cincinnati,10,20,Central Florida,-10
2021-04-11,@Cincinnati,10,6,Central Florida,4
2021-04-16,@Memphis,10,6,Memphis,4
2021-04-16,@Memphis,11,3,Memphis,8
2021-04-17,@Memphis,5,7,Memphis,-2
2021-04-18,@Memphis,8,4,Memphis,4
2021-04-23,@Cincinnati,12,2,Wichita State,10
2021-04-23,@Cincinnati,6,0,Wichita State,6
2021-04-24,@Cincinnati,1,6,Wichita State,-5
2021-04-25,@Cincinnati,6,5,Wichita State,1
2021-04-30,@South Florida,2,4,South Florida,-2
2021-04-30,@South Florida,5,3,South Florida,2
2021-05-01,@South Florida,3,12,South Florida,-9
2021-05-02,@South Florida,6,4,South Florida,2
2021-05-07,@Houston,7,0,Houston,7
2021-05-07,@Houston,7,2,Houston,5
2021-05-08,@Houston,5,6,Houston,-1
2021-05-09,@Houston,10,3,Houston,7
2021-05-14,@Cincinnati,4,8,East Carolina,-4
2021-05-14,@Cincinnati,7,6,East Carolina,1
2021-05-15,@Cincinnati,6,7,East Carolina,-1
2021-05-16,@Cincinnati,2,5,East Carolina,-3
2021-05-20,@Cincinnati,11,8,Tulane,3
2021-05-20,@Cincinnati,10,6,Tulane,4
2021-05-21,@Cincinnati,11,1,Tulane,10
2021-05-22,@Cincinnati,13,12,Tulane,1
2021-05-25,@Cincinnati,10,14,Central Florida,-4
2021-05-26,@East Carolina,9,13,East Carolina,-4
2021-02-19,@Clemson,5,0,Cincinnati,5
2021-02-20,@Clemson,5,2,Cincinnati,3
2021-02-21,@Clemson,8,7,Cincinnati,1
2021-02-27,@South Carolina,2,3,South Carolina,-1
2021-02-28,@South Carolina,7,8,South Carolina,-1
2021-03-02,@Clemson,7,3,East Tennessee State,4
2021-03-05,@Clemson,13,7,Notre Dame,6
2021-03-06,@Clemson,1,3,Notre Dame,-2
2021-03-07,@Clemson,2,3,Notre Dame,-1
2021-03-09,@Clemson,2,12,South Carolina-Upstate,-10
2021-03-12,@North Carolina,3,8,North Carolina,-5
2021-03-13,@North Carolina,4,5,North Carolina,-1
2021-03-14,@North Carolina,3,5,North Carolina,-2
2021-03-16,@Clemson,7,2,Georgia State,5
2021-03-19,@Clemson,8,2,Virginia Tech,6
2021-03-20,@Clemson,3,11,Virginia Tech,-8
2021-03-21,@Clemson,4,2,Virginia Tech,2
2021-03-23,@Clemson,6,4,Georgia Southern,2
2021-03-26,@Boston College,16,12,Boston College,4
2021-03-27,@Boston College,7,2,Boston College,5
2021-03-27,@Boston College,9,3,Boston College,6
2021-03-30,@Clemson,0,2,Georgia,-2
2021-04-02,@North Carolina State,10,6,North Carolina State,4
2021-04-03,@North Carolina State,9,3,North Carolina State,6
2021-04-04,@North Carolina State,5,9,North Carolina State,-4
2021-04-09,@Clemson,6,1,Virginia,5
2021-04-10,@Clemson,4,8,Virginia,-4
2021-04-11,@Clemson,5,6,Virginia,-1
2021-04-13,@Clemson,6,13,College of Charleston,-7
2021-04-16,"@Miami, Florida",3,12,"Miami, Florida",-9
2021-04-17,"@Miami, Florida",2,10,"Miami, Florida",-8
2021-04-18,"@Miami, Florida",2,3,"Miami, Florida",-1
2021-04-20,@Georgia,7,8,Georgia,-1
2021-04-23,@Clemson,5,2,Wake Forest,3
2021-04-25,@Clemson,6,4,Wake Forest,2
2021-04-25,@Clemson,3,2,Wake Forest,1
2021-04-30,@Clemson,11,3,Louisville,8
2021-05-01,@Clemson,5,4,Louisville,1
2021-05-02,@Clemson,15,5,Louisville,10
2021-05-05,@Clemson,9,2,South Carolina-Upstate,7
2021-05-07,@Georgia Tech,1,6,Georgia Tech,-5
2021-05-08,@Georgia Tech,5,6,Georgia Tech,-1
2021-05-09,@Georgia Tech,8,9,Georgia Tech,-1
2021-05-11,@Clemson,7,2,South Carolina,5
2021-05-14,@Florida State,3,8,Florida State,-5
2021-05-15,@Florida State,9,5,Florida State,4
2021-05-16,@Florida State,6,9,Florida State,-3
2021-05-20,@Clemson,1,5,Duke,-4
2021-05-21,@Clemson,8,14,Duke,-6
2021-05-22,@Clemson,2,4,Duke,-2
2021-05-25,@Louisville,10,15,Louisville,-5
2021-05-26,@Clemson,11,5,Georgia Tech,6
2021-02-20,@Coastal Carolina,4,12,Duke,-8
2021-02-21,@Coastal Carolina,8,7,Duke,1
2021-02-21,@Coastal Carolina,9,10,Duke,-1
2021-02-23,@Wake Forest,4,1,Wake Forest,3
2021-02-26,@Coastal Carolina,8,1,Bryant,7
2021-02-27,@Coastal Carolina,10,5,West Virginia,5
2021-02-28,@Coastal Carolina,13,11,Kennesaw State,2
2021-03-05,@Coastal Carolina,15,5,Davidson,10
2021-03-06,@Coastal Carolina,5,3,"Miami, Ohio",2
2021-03-07,@Coastal Carolina,4,5,Connecticut,-1
2021-03-08,@Coastal Carolina,12,10,Connecticut,2
2021-03-12,@Coastal Carolina,6,8,Florida International,-2
2021-03-13,@Coastal Carolina,7,0,Florida International,7
2021-03-13,@Coastal Carolina,4,7,Florida International,-3
2021-03-14,@Coastal Carolina,6,1,Florida International,5
2021-03-19,@West Virginia,5,2,West Virginia,3
2021-03-20,@West Virginia,4,5,West Virginia,-1
2021-03-21,@West Virginia,9,6,West Virginia,3
2021-03-23,@Coastal Carolina,8,7,College of Charleston,1
2021-03-26,@Louisiana-Lafayette,2,9,Louisiana-Lafayette,-7
2021-03-27,@Louisiana-Lafayette,5,3,Louisiana-Lafayette,2
2021-03-28,@Louisiana-Lafayette,3,5,Louisiana-Lafayette,-2
2021-03-29,@Louisiana-Lafayette,0,7,Louisiana-Lafayette,-7
2021-04-10,@Texas-Arlington,8,7,Texas-Arlington,1
2021-04-11,@Texas-Arlington,3,7,Texas-Arlington,-4
2021-04-12,@Texas-Arlington,1,5,Texas-Arlington,-4
2021-04-14,@North Carolina-Wilmington,8,2,North Carolina-Wilmington,6
2021-04-16,@Coastal Carolina,2,8,Georgia Southern,-6
2021-04-17,@Coastal Carolina,3,8,Georgia Southern,-5
2021-04-18,@Coastal Carolina,8,6,Georgia Southern,2
2021-04-20,@North Carolina,6,3,North Carolina,3
2021-04-23,@Liberty,2,7,Liberty,-5
2021-04-24,@Liberty,2,0,Liberty,2
2021-04-25,@Liberty,4,6,Liberty,-2
2021-04-27,@Coastal Carolina,1,11,North Carolina-Wilmington,-10
2021-04-28,@North Carolina-Wilmington,6,7,North Carolina-Wilmington,-1
2021-04-30,@Georgia State,1,2,Georgia State,-1
2021-05-01,@Georgia State,8,4,Georgia State,4
2021-05-02,@Georgia State,12,10,Georgia State,2
2021-05-07,@Coastal Carolina,7,9,Troy,-2
2021-05-08,@Coastal Carolina,7,9,Troy,-2
2021-05-09,@Coastal Carolina,6,10,Troy,-4
2021-05-14,@South Alabama,4,2,South Alabama,2
2021-05-15,@South Alabama,1,3,South Alabama,-2
2021-05-16,@South Alabama,1,4,South Alabama,-3
2021-05-18,@Coastal Carolina,14,9,Wake Forest,5
2021-05-20,@Coastal Carolina,10,5,Texas State,5
2021-05-21,@Coastal Carolina,8,7,Texas State,1
2021-05-22,@Coastal Carolina,12,2,Texas State,10
2021-05-25,@Arkansas-Little Rock,15,1,Arkansas-Little Rock,14
2021-05-26,@South Alabama,7,14,South Alabama,-7
2021-02-20,@College of Charleston,1,0,North Carolina A&T,1
2021-02-21,@College of Charleston,14,2,North Carolina A&T,12
2021-02-21,@College of Charleston,3,4,North Carolina A&T,-1
2021-02-24,@College of Charleston,7,18,Georgia Southern,-11
2021-02-26,@College of Charleston,3,10,South Carolina-Upstate,-7
2021-02-27,@College of Charleston,0,1,South Carolina-Upstate,-1
2021-02-28,@College of Charleston,10,13,South Carolina-Upstate,-3
2021-03-05,@College of Charleston,0,8,Alabama,-8
2021-03-06,@College of Charleston,1,0,Alabama,1
2021-03-07,@College of Charleston,3,21,Alabama,-18
2021-03-09,@Campbell,2,3,Campbell,-1
2021-03-12,@College of Charleston,3,7,William and Mary,-4
2021-03-13,@College of Charleston,6,4,William and Mary,2
2021-03-13,@College of Charleston,7,1,William and Mary,6
2021-03-23,@Coastal Carolina,7,8,Coastal Carolina,-1
2021-03-26,@College of Charleston,1,6,North Carolina-Wilmington,-5
2021-03-27,@College of Charleston,11,8,North Carolina-Wilmington,3
2021-03-28,@College of Charleston,10,9,North Carolina-Wilmington,1
2021-03-30,@Georgia Southern,6,3,Georgia Southern,3
2021-04-02,@James Madison,3,9,James Madison,-6
2021-04-03,@James Madison,4,7,James Madison,-3
2021-04-04,@James Madison,3,1,James Madison,2
2021-04-06,@College of Charleston,5,4,The Citadel,1
2021-04-10,@College of Charleston,4,5,Tennessee Tech,-1
2021-04-10,@College of Charleston,9,6,Tennessee Tech,3
2021-04-11,@College of Charleston,8,0,Tennessee Tech,8
2021-04-13,@Clemson,13,6,Clemson,7
2021-04-16,@College of Charleston,14,7,James Madison,7
2021-04-17,@College of Charleston,15,3,James Madison,12
2021-04-18,@College of Charleston,1,7,James Madison,-6
2021-04-20,@The Citadel,11,2,The Citadel,9
2021-04-21,@Wofford,5,12,Wofford,-7
2021-04-23,@College of Charleston,6,3,Emmanuel College,3
2021-04-30,@Elon,5,14,Elon,-9
2021-05-01,@Elon,11,12,Elon,-1
2021-05-02,@Elon,6,3,Elon,3
2021-05-07,@William and Mary,9,4,William and Mary,5
2021-05-08,@William and Mary,5,4,William and Mary,1
2021-05-08,@William and Mary,10,1,William and Mary,9
2021-05-11,@The Citadel,6,3,The Citadel,3
2021-05-14,@North Carolina-Wilmington,2,7,North Carolina-Wilmington,-5
2021-05-15,@North Carolina-Wilmington,6,7,North Carolina-Wilmington,-1
2021-05-16,@North Carolina-Wilmington,4,8,North Carolina-Wilmington,-4
2021-05-18,@College of Charleston,10,3,The Citadel,7
2021-05-20,@College of Charleston,7,10,Elon,-3
2021-05-21,@College of Charleston,7,6,Elon,1
2021-05-22,@College of Charleston,7,9,Elon,-2
2021-05-26,@College of Charleston,6,5,Towson,1
2021-05-27,@Northeastern,3,10,Northeastern,-7
2021-05-28,@College of Charleston,6,2,Elon,4
2021-05-28,@William and Mary,8,3,William and Mary,5
2021-05-29,@College of Charleston,1,5,Northeastern,-4
2021-02-19,@Virginia,1,2,Virginia,-1
2021-02-20,@Virginia,10,9,Virginia,1
2021-02-21,@Virginia,2,4,Virginia,-2
2021-02-26,@Southern Mississippi,5,6,Southern Mississippi,-1
2021-02-27,@Southern Mississippi,6,7,Southern Mississippi,-1
2021-02-28,@Southern Mississippi,10,7,Southern Mississippi,3
2021-03-05,@Connecticut,5,0,"Miami, Ohio",5
2021-03-06,@Davidson,3,4,Davidson,-1
2021-03-07,@Coastal Carolina,5,4,Coastal Carolina,1
2021-03-08,@Coastal Carolina,10,12,Coastal Carolina,-2
2021-03-12,@Texas Tech,3,4,Texas Tech,-1
2021-03-13,@Texas Tech,3,10,Texas Tech,-7
2021-03-14,@Texas Tech,13,15,Texas Tech,-2
2021-03-15,@Texas Tech,8,9,Texas Tech,-1
2021-03-19,@St. Joseph's,6,4,St. Joseph's,2
2021-03-20,@St. Joseph's,8,9,St. Joseph's,-1
2021-03-21,@St. Joseph's,13,0,St. Joseph's,13
2021-03-23,@Connecticut,2,0,Central Connecticut State,2
2021-03-26,@Connecticut,9,6,Rhode Island,3
2021-03-27,@Connecticut,3,2,Rhode Island,1
2021-03-27,@Connecticut,4,6,Rhode Island,-2
2021-03-30,@Connecticut,12,0,Boston College,12
2021-04-02,@Connecticut,9,2,Massachusetts,7
2021-04-03,@Connecticut,11,1,Massachusetts,10
2021-04-03,@Connecticut,7,3,Massachusetts,4
2021-04-06,@Connecticut,9,8,Bryant,1
2021-04-09,@Connecticut,10,0,Georgetown,10
2021-04-10,@Connecticut,6,0,Georgetown,6
2021-04-25,@Xavier,8,5,Xavier,3
2021-04-25,@Xavier,0,5,Xavier,-5
2021-04-27,@Xavier,5,6,Xavier,-1
2021-04-27,@Xavier,15,13,Xavier,2
2021-05-01,@Connecticut,9,1,Bucknell,8
2021-05-02,@Connecticut,13,6,Bucknell,7
2021-05-07,@St. John's,4,3,St. John's,1
2021-05-08,@St. John's,6,0,St. John's,6
2021-05-08,@St. John's,3,4,St. John's,-1
2021-05-09,@St. John's,5,3,St. John's,2
2021-05-14,@Villanova,2,3,Villanova,-1
2021-05-15,@Villanova,9,4,Villanova,5
2021-05-16,@Villanova,4,3,Villanova,1
2021-05-18,@Rhode Island,15,6,Rhode Island,9
2021-05-20,@Connecticut,11,4,Seton Hall,7
2021-05-21,@Connecticut,15,1,Seton Hall,14
2021-05-21,@Connecticut,12,4,Seton Hall,8
2021-05-22,@Connecticut,10,2,Seton Hall,8
2021-05-27,@Connecticut,11,1,Xavier,10
2021-05-29,@Connecticut,2,0,Creighton,2
2021-05-30,@Connecticut,10,6,Xavier,4
2021-05-30,@Connecticut,4,5,Xavier,-1
2021-06-04,@Connecticut,6,1,Michigan,5
2021-06-05,@Connecticut,3,26,Notre Dame,-23
2021-06-06,@Central Michigan,9,14,Central Michigan,-5
2021-02-21,@Navy,2,7,Navy,-5
2021-02-24,@Navy,11,16,Navy,-5
2021-02-27,@Coppin State,0,9,Lehigh,-9
2021-02-27,@Coppin State,1,10,Lehigh,-9
2021-03-05,@Mount St. Mary's,9,10,Mount St. Mary's,-1
2021-03-06,@Mount St. Mary's,15,5,Mount St. Mary's,10
2021-03-06,@Mount St. Mary's,7,3,Mount St. Mary's,4
2021-03-07,@Mount St. Mary's,3,7,Mount St. Mary's,-4
2021-03-10,@George Washington,4,9,George Washington,-5
2021-03-14,@LaSalle,10,11,LaSalle,-1
2021-03-20,@Delaware State,9,3,Delaware State,6
2021-03-20,@Delaware State,4,6,Delaware State,-2
2021-03-21,@Delaware State,12,13,Delaware State,-1
2021-03-21,@Delaware State,8,5,Delaware State,3
2021-03-26,@Coppin State,13,12,Norfolk State,1
2021-03-26,@Coppin State,1,4,Norfolk State,-3
2021-03-27,@Coppin State,3,9,Norfolk State,-6
2021-03-27,@Coppin State,5,10,Norfolk State,-5
2021-04-07,@Coppin State,8,16,LaSalle,-8
2021-04-09,@Coppin State,6,8,Delaware State,-2
2021-04-10,@Coppin State,5,8,Delaware State,-3
2021-04-10,@Coppin State,5,7,Delaware State,-2
2021-04-16,@Norfolk State,3,5,Norfolk State,-2
2021-04-17,@Norfolk State,2,3,Norfolk State,-1
2021-04-17,@Norfolk State,2,6,Norfolk State,-4
2021-04-18,@Norfolk State,3,9,Norfolk State,-6
2021-04-23,@Coppin State,2,9,North Carolina A&T,-7
2021-04-23,@Coppin State,7,16,North Carolina A&T,-9
2021-04-24,@Coppin State,6,5,North Carolina A&T,1
2021-04-24,@Coppin State,3,9,North Carolina A&T,-6
2021-04-28,@Navy,12,10,Navy,2
2021-04-30,@Delaware State,7,8,Delaware State,-1
2021-05-01,@Delaware State,13,12,Delaware State,1
2021-05-01,@Delaware State,13,11,Delaware State,2
2021-05-02,@Delaware State,12,8,Delaware State,4
2021-05-13,@North Carolina A&T,5,6,North Carolina A&T,-1
2021-05-14,@North Carolina A&T,0,8,North Carolina A&T,-8
2021-05-14,@North Carolina A&T,2,4,North Carolina A&T,-2
2021-05-15,@North Carolina A&T,4,10,North Carolina A&T,-6
2021-02-26,@Lipscomb,11,4,Lipscomb,7
2021-02-27,@Belmont,9,3,Belmont,6
2021-02-27,@Belmont,2,3,Belmont,-1
2021-02-28,@Lipscomb,5,7,Lipscomb,-2
2021-03-05,@Nebraska-Omaha,10,3,Nebraska-Omaha,7
2021-03-06,@Nebraska-Omaha,15,2,Nebraska-Omaha,13
2021-03-07,@Nebraska-Omaha,2,5,Nebraska-Omaha,-3
2021-03-19,@Kansas,6,7,Kansas,-1
2021-03-20,@Kansas,3,11,Kansas,-8
2021-03-20,@Kansas,3,11,Kansas,-8
2021-03-21,@Kansas,4,7,Kansas,-3
2021-03-27,@Creighton,6,4,Bradley,2
2021-03-28,@Creighton,9,5,Bradley,4
2021-04-09,@Creighton,9,2,Villanova,7
2021-04-10,@Creighton,10,0,Villanova,10
2021-04-11,@Creighton,8,0,Villanova,8
2021-04-17,@Creighton,5,0,San Jose State,5
2021-04-18,@Creighton,6,4,San Jose State,2
2021-04-23,@Georgetown,5,0,Georgetown,5
2021-04-23,@Georgetown,6,0,Georgetown,6
2021-04-24,@Georgetown,4,2,Georgetown,2
2021-04-25,@Georgetown,2,3,Georgetown,-1
2021-04-30,@Creighton,6,1,St. John's,5
2021-05-01,@Creighton,1,4,St. John's,-3
2021-05-01,@Creighton,11,4,St. John's,7
2021-05-02,@Creighton,11,4,St. John's,7
2021-05-08,@Butler,8,2,Butler,6
2021-05-08,@Butler,11,10,Butler,1
2021-05-14,@Seton Hall,6,1,Seton Hall,5
2021-05-15,@Seton Hall,0,15,Seton Hall,-15
2021-05-15,@Seton Hall,3,5,Seton Hall,-2
2021-05-16,@Seton Hall,3,1,Seton Hall,2
2021-05-20,@Creighton,5,10,Xavier,-5
2021-05-21,@Creighton,3,2,Xavier,1
2021-05-21,@Creighton,2,6,Xavier,-4
2021-05-22,@Creighton,3,2,Xavier,1
2021-05-27,@Creighton,8,7,Seton Hall,1
2021-05-29,@Connecticut,0,2,Connecticut,-2
2021-05-29,@Creighton,1,2,Xavier,-1
2021-02-20,@Dallas Baptist,13,2,Austin Peay State,11
2021-02-21,@Dallas Baptist,11,2,Austin Peay State,9
2021-02-22,@Dallas Baptist,12,2,Austin Peay State,10
2021-02-25,@Dallas Baptist,7,10,Gonzaga,-3
2021-02-26,@Dallas Baptist,13,2,Gonzaga,11
2021-02-27,@Dallas Baptist,7,19,Gonzaga,-12
2021-02-28,@Dallas Baptist,8,7,Gonzaga,1
2021-03-04,@Dallas Baptist,3,2,Missouri,1
2021-03-05,@Missouri,8,0,Missouri,8
2021-03-06,@Arizona,8,15,Arizona,-7
2021-03-07,@Dallas Baptist,9,3,Oklahoma,6
2021-03-12,@Dallas Baptist,7,10,Oral Roberts,-3
2021-03-13,@Dallas Baptist,6,7,Oral Roberts,-1
2021-03-14,@Dallas Baptist,17,6,Oral Roberts,11
2021-03-18,@Dallas Baptist,4,5,Tarleton State,-1
2021-03-19,@Dallas Baptist,10,3,Tarleton State,7
2021-03-20,@Dallas Baptist,8,5,Tarleton State,3
2021-03-25,@Dallas Baptist,10,2,Texas-Rio Grande Valley,8
2021-03-26,@Dallas Baptist,4,2,Texas-Rio Grande Valley,2
2021-03-27,@Dallas Baptist,6,5,Texas-Rio Grande Valley,1
2021-03-28,@Dallas Baptist,4,5,Texas-Rio Grande Valley,-1
2021-04-01,@Dallas Baptist,6,1,Valparaiso,5
2021-04-02,@Dallas Baptist,9,8,Valparaiso,1
2021-04-02,@Dallas Baptist,8,4,Valparaiso,4
2021-04-03,@Dallas Baptist,5,2,Valparaiso,3
2021-04-16,@Dallas Baptist,2,0,Air Force,2
2021-04-17,@Dallas Baptist,0,3,Air Force,-3
2021-04-18,@Dallas Baptist,3,5,Air Force,-2
2021-04-23,@Dallas Baptist,8,5,Indiana State,3
2021-04-24,@Dallas Baptist,6,5,Indiana State,1
2021-04-24,@Dallas Baptist,9,0,Indiana State,9
2021-04-25,@Dallas Baptist,5,7,Indiana State,-2
2021-04-30,@Evansville,2,1,Evansville,1
2021-05-01,@Evansville,3,4,Evansville,-1
2021-05-01,@Evansville,6,5,Evansville,1
2021-05-02,@Evansville,20,1,Evansville,19
2021-05-07,@Dallas Baptist,18,7,Illinois State,11
2021-05-08,@Dallas Baptist,6,3,Illinois State,3
2021-05-08,@Dallas Baptist,11,7,Illinois State,4
2021-05-09,@Dallas Baptist,3,0,Illinois State,3
2021-05-14,@Dallas Baptist,4,8,Bradley,-4
2021-05-14,@Dallas Baptist,5,2,Bradley,3
2021-05-15,@Dallas Baptist,16,6,Bradley,10
2021-05-15,@Dallas Baptist,10,13,Bradley,-3
2021-05-20,@Southern Illinois,19,0,Southern Illinois,19
2021-05-21,@Southern Illinois,3,0,Southern Illinois,3
2021-05-21,@Southern Illinois,8,9,Southern Illinois,-1
2021-05-22,@Southern Illinois,3,5,Southern Illinois,-2
2021-05-26,@Dallas Baptist,12,2,Valparaiso,10
2021-05-28,@Dallas Baptist,10,5,Bradley,5
2021-05-29,@Indiana State,10,1,Indiana State,9
2021-05-30,@Indiana State,12,8,Indiana State,4
2021-06-04,@Oregon State,6,5,Oregon State,1
2021-06-05,@Dallas Baptist,8,6,Texas Christian,2
2021-06-06,@Oregon State,4,5,Oregon State,-1
2021-06-07,@Dallas Baptist,8,5,Oregon State,3
2021-06-12,@Dallas Baptist,6,5,Virginia,1
2021-06-13,@Virginia,0,4,Virginia,-4
2021-06-14,@Virginia,2,5,Virginia,-3
2021-02-20,@Davidson,14,8,Morehead State,6
2021-02-21,@North Carolina State,4,6,North Carolina State,-2
2021-02-21,@North Carolina State,3,13,North Carolina State,-10
2021-02-27,@Davidson,12,2,Toledo,10
2021-02-27,@Davidson,8,1,Toledo,7
2021-02-28,@Davidson,16,14,Toledo,2
2021-03-02,@Duke,3,7,Duke,-4
2021-03-05,@Coastal Carolina,5,15,Coastal Carolina,-10
2021-03-06,@Davidson,4,3,Connecticut,1
2021-03-07,"@Miami, Ohio",3,11,"Miami, Ohio",-8
2021-03-12,@The Citadel,0,2,The Citadel,-2
2021-03-13,@The Citadel,0,19,The Citadel,-19
2021-03-14,@The Citadel,4,8,The Citadel,-4
2021-03-17,@South Carolina,9,4,South Carolina,5
2021-03-19,@Davidson,7,2,Spring Hill,5
2021-03-20,@Davidson,5,1,Spring Hill,4
2021-03-21,@Davidson,8,5,Spring Hill,3
2021-03-23,@Wofford,1,5,Wofford,-4
2021-03-26,@Davidson,6,5,Seton Hall,1
2021-03-27,@Davidson,2,1,Seton Hall,1
2021-03-28,@Davidson,3,2,Seton Hall,1
2021-03-30,@Davidson,7,6,Wofford,1
2021-04-01,@Davidson,8,4,North Alabama,4
2021-04-02,@Davidson,6,4,North Alabama,2
2021-04-03,@Davidson,5,0,North Alabama,5
2021-04-09,@Davidson,10,8,Dayton,2
2021-04-09,@Davidson,2,1,Dayton,1
2021-04-10,@Davidson,12,9,Dayton,3
2021-04-11,@Davidson,5,11,Dayton,-6
2021-04-16,@Virginia Commonwealth,3,14,Virginia Commonwealth,-11
2021-04-17,@Virginia Commonwealth,8,9,Virginia Commonwealth,-1
2021-04-17,@Virginia Commonwealth,1,5,Virginia Commonwealth,-4
2021-04-18,@Virginia Commonwealth,1,3,Virginia Commonwealth,-2
2021-04-23,@Davidson,2,10,George Washington,-8
2021-04-23,@Davidson,2,4,George Washington,-2
2021-04-25,@Davidson,1,8,George Washington,-7
2021-04-25,@Davidson,5,4,George Washington,1
2021-04-27,@Wake Forest,12,17,Wake Forest,-5
2021-04-30,@Richmond,4,6,Richmond,-2
2021-05-01,@Richmond,1,3,Richmond,-2
2021-05-01,@Richmond,4,2,Richmond,2
2021-05-02,@Richmond,17,7,Richmond,10
2021-05-14,@Davidson,3,5,George Mason,-2
2021-05-15,@Davidson,5,4,George Mason,1
2021-05-15,@Davidson,8,7,George Mason,1
2021-05-16,@Davidson,4,10,George Mason,-6
2021-05-18,@Davidson,2,18,Duke,-16
2021-05-20,@St. Louis,11,3,St. Louis,8
2021-05-21,@St. Louis,4,1,St. Louis,3
2021-05-21,@St. Louis,5,7,St. Louis,-2
2021-05-22,@St. Louis,6,3,St. Louis,3
2021-02-19,@South Carolina,1,12,South Carolina,-11
2021-02-20,@South Carolina,5,12,South Carolina,-7
2021-02-21,@South Carolina,1,5,South Carolina,-4
2021-02-26,@Campbell,1,8,Campbell,-7
2021-02-27,@Campbell,5,4,Campbell,1
2021-02-28,@Campbell,2,11,Campbell,-9
2021-03-05,@Dayton,10,1,Oakland,9
2021-03-06,@Dayton,3,5,Oakland,-2
2021-03-06,@Dayton,1,2,Oakland,-1
2021-03-07,@Dayton,7,6,Oakland,1
2021-03-12,@Dayton,1,5,North Dakota State,-4
2021-03-13,@Dayton,1,9,North Dakota State,-8
2021-03-14,@Dayton,3,4,North Dakota State,-1
2021-03-16,@Dayton,3,9,North Dakota State,-6
2021-03-19,@Dayton,3,1,Central Michigan,2
2021-03-20,@Dayton,4,5,Central Michigan,-1
2021-03-20,@Dayton,3,13,Central Michigan,-10
2021-03-21,@Dayton,4,15,Central Michigan,-11
2021-03-24,@Eastern Kentucky,20,13,Eastern Kentucky,7
2021-03-26,@Dayton,14,2,Kent State,12
2021-03-27,@Dayton,3,11,Kent State,-8
2021-03-28,@Kent State,10,5,Kent State,5
2021-03-28,@Kent State,4,0,Kent State,4
2021-03-30,@Dayton,18,7,Akron,11
2021-04-02,@Xavier,1,5,Xavier,-4
2021-04-02,@Xavier,4,1,Xavier,3
2021-04-03,@Dayton,16,24,Xavier,-8
2021-04-03,@Dayton,11,14,Xavier,-3
2021-04-06,@Dayton,7,10,Morehead State,-3
2021-04-09,@Davidson,1,2,Davidson,-1
2021-04-09,@Davidson,8,10,Davidson,-2
2021-04-10,@Davidson,9,12,Davidson,-3
2021-04-11,@Davidson,11,5,Davidson,6
2021-04-16,@Dayton,6,7,George Mason,-1
2021-04-17,@Dayton,11,1,George Mason,10
2021-04-17,@Dayton,12,10,George Mason,2
2021-04-18,@Dayton,14,3,George Mason,11
2021-05-07,@Richmond,8,3,Richmond,5
2021-05-08,@Richmond,3,2,Richmond,1
2021-05-08,@Richmond,5,2,Richmond,3
2021-05-09,@Richmond,20,10,Richmond,10
2021-05-16,@West Virginia,6,12,West Virginia,-6
2021-05-16,@West Virginia,6,7,West Virginia,-1
2021-05-20,@Dayton,6,4,George Washington,2
2021-05-21,@Dayton,7,4,George Washington,3
2021-05-21,@Dayton,11,4,George Washington,7
2021-05-22,@Dayton,14,9,George Washington,5
2021-05-27,@Dayton,2,8,Rhode Island,-6
2021-05-27,@St. Joseph's,11,5,St. Joseph's,6
2021-05-28,@Rhode Island,3,1,Rhode Island,2
2021-05-29,@Dayton,6,7,Virginia Commonwealth,-1
2021-03-07,@Delaware,14,4,LaSalle,10
2021-03-07,@Delaware,7,4,LaSalle,3
2021-03-13,@Villanova,5,6,Villanova,-1
2021-03-14,@Delaware,10,11,Villanova,-1
2021-03-20,@Lehigh,5,0,Lehigh,5
2021-03-20,@Lehigh,2,3,Lehigh,-1
2021-03-27,@Delaware,2,15,Fordham,-13
2021-03-27,@Delaware,1,8,Fordham,-7
2021-04-02,@Towson,12,0,Towson,12
2021-04-03,@Towson,2,10,Towson,-8
2021-04-03,@Towson,6,7,Towson,-1
2021-04-04,@Towson,3,8,Towson,-5
2021-04-10,@Pennsylvania,1,9,Pennsylvania,-8
2021-04-10,@Pennsylvania,4,0,Pennsylvania,4
2021-04-16,@Delaware,10,9,Hofstra,1
2021-04-17,@Delaware,4,14,Hofstra,-10
2021-04-17,@Delaware,7,5,Hofstra,2
2021-04-18,@Delaware,11,5,Hofstra,6
2021-04-23,@Northeastern,0,1,Northeastern,-1
2021-04-23,@Northeastern,5,6,Northeastern,-1
2021-04-24,@Northeastern,4,9,Northeastern,-5
2021-04-24,@Northeastern,1,3,Northeastern,-2
2021-04-30,@Hofstra,11,14,Hofstra,-3
2021-05-01,@Hofstra,7,8,Hofstra,-1
2021-05-01,@Hofstra,0,9,Hofstra,-9
2021-05-02,@Hofstra,22,8,Hofstra,14
2021-05-07,@Delaware,5,6,Towson,-1
2021-05-08,@Delaware,4,12,Towson,-8
2021-05-08,@Delaware,7,12,Towson,-5
2021-05-09,@Delaware,9,3,Towson,6
2021-05-14,@Delaware,1,8,Northeastern,-7
2021-05-15,@Delaware,5,3,Northeastern,2
2021-05-15,@Delaware,4,26,Northeastern,-22
2021-05-16,@Delaware,9,7,Northeastern,2
2021-03-02,@LaSalle,6,10,LaSalle,-4
2021-03-06,@Maryland-Baltimore County,8,20,Maryland-Baltimore County,-12
2021-03-07,@Maryland-Baltimore County,2,18,Maryland-Baltimore County,-16
2021-03-07,@Maryland-Baltimore County,6,14,Maryland-Baltimore County,-8
2021-03-12,@Mount St. Mary's,11,13,Mount St. Mary's,-2
2021-03-14,@Mount St. Mary's,11,5,Mount St. Mary's,6
2021-03-14,@Mount St. Mary's,32,11,Mount St. Mary's,21
2021-03-20,@Delaware State,6,4,Coppin State,2
2021-03-20,@Delaware State,3,9,Coppin State,-6
2021-03-21,@Delaware State,5,8,Coppin State,-3
2021-03-21,@Delaware State,13,12,Coppin State,1
2021-03-27,@George Washington,1,8,George Washington,-7
2021-03-27,@George Washington,1,16,George Washington,-15
2021-03-28,@George Washington,2,8,George Washington,-6
2021-04-01,@Norfolk State,5,2,Norfolk State,3
2021-04-02,@Norfolk State,2,7,Norfolk State,-5
2021-04-02,@Norfolk State,3,5,Norfolk State,-2
2021-04-03,@Norfolk State,2,1,Norfolk State,1
2021-04-09,@Coppin State,8,6,Coppin State,2
2021-04-10,@Coppin State,8,5,Coppin State,3
2021-04-10,@Coppin State,7,5,Coppin State,2
2021-04-16,@Delaware State,8,3,North Carolina Central,5
2021-04-17,@Delaware State,3,9,North Carolina Central,-6
2021-04-17,@Delaware State,3,2,North Carolina Central,1
2021-04-18,@Delaware State,0,6,North Carolina Central,-6
2021-04-23,@Delaware State,6,10,Norfolk State,-4
2021-04-23,@Delaware State,4,7,Norfolk State,-3
2021-04-24,@Delaware State,9,4,Norfolk State,5
2021-04-24,@Delaware State,2,3,Norfolk State,-1
2021-04-30,@Delaware State,8,7,Coppin State,1
2021-05-01,@Delaware State,12,13,Coppin State,-1
2021-05-01,@Delaware State,11,13,Coppin State,-2
2021-05-02,@Delaware State,8,12,Coppin State,-4
2021-05-07,@North Carolina Central,0,10,North Carolina Central,-10
2021-05-08,@North Carolina Central,3,2,North Carolina Central,1
2021-05-08,@North Carolina Central,6,15,North Carolina Central,-9
2021-05-09,@North Carolina Central,1,11,North Carolina Central,-10
2021-05-13,@Norfolk State,0,6,Norfolk State,-6
2021-05-14,@Norfolk State,7,8,Norfolk State,-1
2021-05-14,@Norfolk State,6,2,Norfolk State,4
2021-05-15,@Norfolk State,9,10,Norfolk State,-1
2021-05-20,@North Carolina Central,4,9,North Carolina Central,-5
2021-05-21,@Florida A&M,13,14,Florida A&M,-1
2021-02-25,@Dixie State,3,6,Washington State,-3
2021-02-26,@Dixie State,5,19,Washington State,-14
2021-02-27,@Dixie State,1,15,Washington State,-14
2021-02-28,@Dixie State,3,10,Washington State,-7
2021-03-05,@Wichita State,1,2,Wichita State,-1
2021-03-06,@Wichita State,3,15,Wichita State,-12
2021-03-07,@Wichita State,7,15,Wichita State,-8
2021-03-12,@New Mexico State,3,17,New Mexico State,-14
2021-03-13,@New Mexico State,2,19,New Mexico State,-17
2021-03-13,@New Mexico State,3,14,New Mexico State,-11
2021-03-14,@New Mexico State,19,13,New Mexico State,6
2021-03-16,@Dixie State,5,4,Brigham Young,1
2021-03-19,@Dixie State,7,6,Texas-Rio Grande Valley,1
2021-03-20,@Dixie State,3,13,Texas-Rio Grande Valley,-10
2021-03-20,@Dixie State,1,18,Texas-Rio Grande Valley,-17
2021-03-21,@Dixie State,3,2,Texas-Rio Grande Valley,1
2021-03-23,@Utah,9,7,Utah,2
2021-03-26,@Sacramento State,3,9,Sacramento State,-6
2021-03-27,@Sacramento State,5,10,Sacramento State,-5
2021-03-27,@Sacramento State,4,9,Sacramento State,-5
2021-03-28,@Sacramento State,7,5,Sacramento State,2
2021-04-01,@Tarleton State,9,10,Tarleton State,-1
2021-04-02,@Tarleton State,5,1,Tarleton State,4
2021-04-02,@Tarleton State,7,4,Tarleton State,3
2021-04-03,@Tarleton State,13,9,Tarleton State,4
2021-04-06,@Dixie State,3,16,Utah,-13
2021-04-09,@Southern California,1,14,Southern California,-13
2021-04-10,@Southern California,3,10,Southern California,-7
2021-04-11,@Southern California,5,6,Southern California,-1
2021-04-16,@Dixie State,3,1,California Baptist,2
2021-04-17,@Dixie State,4,7,California Baptist,-3
2021-04-17,@Dixie State,2,1,California Baptist,1
2021-04-18,@Dixie State,8,14,California Baptist,-6
2021-04-20,@Brigham Young,2,3,Brigham Young,-1
2021-04-24,@San Diego State,4,5,San Diego State,-1
2021-04-24,@San Diego State,7,8,San Diego State,-1
2021-04-25,@San Diego State,1,9,San Diego State,-8
2021-04-30,@Dixie State,9,8,Utah Valley,1
2021-05-01,@Dixie State,4,2,Utah Valley,2
2021-05-01,@Dixie State,10,9,Utah Valley,1
2021-05-02,@Dixie State,11,0,Utah Valley,11
2021-05-07,@Grand Canyon,0,10,Grand Canyon,-10
2021-05-08,@Grand Canyon,3,4,Grand Canyon,-1
2021-05-08,@Grand Canyon,0,5,Grand Canyon,-5
2021-05-09,@Grand Canyon,3,6,Grand Canyon,-3
2021-05-14,@Dixie State,6,3,Seattle,3
2021-05-15,@Dixie State,9,7,Seattle,2
2021-05-15,@Dixie State,14,13,Seattle,1
2021-05-16,@Dixie State,14,4,Seattle,10
2021-05-20,@Dixie State,6,3,Northern Colorado,3
2021-05-21,@Dixie State,6,3,Northern Colorado,3
2021-05-21,@Dixie State,11,2,Northern Colorado,9
2021-05-22,@Dixie State,9,6,Northern Colorado,3
2021-05-27,@Arizona,2,4,Arizona,-2
2021-05-28,@Arizona,11,9,Arizona,2
2021-05-29,@Arizona,4,5,Arizona,-1
2021-02-20,@Coastal Carolina,12,4,Coastal Carolina,8
2021-02-21,@Coastal Carolina,7,8,Coastal Carolina,-1
2021-02-21,@Coastal Carolina,10,9,Coastal Carolina,1
2021-02-23,@East Carolina,1,6,East Carolina,-5
2021-02-27,@Duke,10,3,Boston College,7
2021-02-27,@Duke,6,10,Boston College,-4
2021-02-28,@Duke,2,5,Boston College,-3
2021-03-02,@Duke,7,3,Davidson,4
2021-03-05,@Duke,3,1,Pittsburgh,2
2021-03-06,@Duke,8,1,Pittsburgh,7
2021-03-07,@Duke,4,5,Pittsburgh,-1
2021-03-09,@Duke,5,11,East Carolina,-6
2021-03-16,@Duke,7,4,North Carolina Central,3
2021-03-19,@Notre Dame,4,6,Notre Dame,-2
2021-03-20,@Notre Dame,2,6,Notre Dame,-4
2021-03-21,@Notre Dame,2,0,Notre Dame,2
2021-03-23,@Duke,5,2,North Carolina-Greensboro,3
2021-03-26,@Duke,2,5,Georgia Tech,-3
2021-03-27,@Duke,0,3,Georgia Tech,-3
2021-03-28,@Duke,9,7,Georgia Tech,2
2021-03-30,@Duke,5,4,Liberty,1
2021-04-02,"@Miami, Florida",1,3,"Miami, Florida",-2
2021-04-03,"@Miami, Florida",5,11,"Miami, Florida",-6
2021-04-04,"@Miami, Florida",1,7,"Miami, Florida",-6
2021-04-06,@Duke,12,7,North Carolina Central,5
2021-04-10,@North Carolina,4,2,North Carolina,2
2021-04-11,@North Carolina,5,11,North Carolina,-6
2021-04-12,@North Carolina,8,21,North Carolina,-13
2021-04-13,@Duke,14,7,Campbell,7
2021-04-16,@Duke,0,11,Wake Forest,-11
2021-04-17,@Duke,11,2,Wake Forest,9
2021-04-18,@Duke,11,7,Wake Forest,4
2021-04-20,@Liberty,7,0,Liberty,7
2021-04-23,@Virginia,3,9,Virginia,-6
2021-04-24,@Virginia,3,4,Virginia,-1
2021-04-25,@Virginia,7,4,Virginia,3
2021-05-04,@Duke,11,6,William and Mary,5
2021-05-07,@Louisville,13,3,Louisville,10
2021-05-08,@Louisville,1,5,Louisville,-4
2021-05-08,@Louisville,6,15,Louisville,-9
2021-05-11,@Duke,9,6,Wofford,3
2021-05-14,@Duke,11,6,Virginia Tech,5
2021-05-15,@Duke,4,1,Virginia Tech,3
2021-05-16,@Duke,2,1,Virginia Tech,1
2021-05-18,@Davidson,18,2,Davidson,16
2021-05-20,@Clemson,5,1,Clemson,4
2021-05-21,@Clemson,14,8,Clemson,6
2021-05-22,@Clemson,4,2,Clemson,2
2021-05-26,@Florida State,12,1,Florida State,11
2021-05-27,@Duke,3,2,"Miami, Florida",1
2021-05-29,@Virginia,4,2,Virginia,2
2021-05-30,@North Carolina State,1,0,North Carolina State,1
2021-06-04,@Duke,6,11,Liberty,-5
2021-06-05,@Wright State,14,6,Wright State,8
2021-06-06,@Liberty,4,15,Liberty,-11
2021-02-19,@East Carolina,3,2,Rhode Island,1
2021-02-20,@East Carolina,7,1,Rhode Island,6
2021-02-21,@East Carolina,12,4,Rhode Island,8
2021-02-23,@East Carolina,6,1,Duke,5
2021-02-26,@Georgia Southern,6,4,Georgia Southern,2
2021-02-27,@Georgia Southern,7,10,Georgia Southern,-3
2021-02-28,@Georgia Southern,9,2,Georgia Southern,7
2021-03-03,@East Carolina,5,6,Old Dominion,-1
2021-03-05,@East Carolina,13,2,Appalachian State,11
2021-03-06,@East Carolina,5,2,Appalachian State,3
2021-03-07,@East Carolina,10,2,Appalachian State,8
2021-03-09,@Duke,11,5,Duke,6
2021-03-12,@East Carolina,7,4,North Carolina-Charlotte,3
2021-03-13,@East Carolina,3,1,North Carolina-Charlotte,2
2021-03-14,@East Carolina,3,1,North Carolina-Charlotte,2
2021-03-17,@North Carolina-Wilmington,2,10,North Carolina-Wilmington,-8
2021-03-19,@East Carolina,4,3,Illinois State,1
2021-03-20,@East Carolina,11,5,Illinois State,6
2021-03-21,@East Carolina,11,8,Illinois State,3
2021-03-23,@North Carolina,1,8,North Carolina,-7
2021-03-26,@Elon,15,0,Elon,15
2021-03-27,@Elon,1,2,Elon,-1
2021-03-30,@East Carolina,11,10,North Carolina,1
2021-04-01,@East Carolina,5,4,Cincinnati,1
2021-04-02,@East Carolina,7,0,Cincinnati,7
2021-04-03,@East Carolina,2,0,Cincinnati,2
2021-04-03,@East Carolina,13,3,Cincinnati,10
2021-04-09,@East Carolina,5,3,Memphis,2
2021-04-09,@East Carolina,12,2,Memphis,10
2021-04-10,@East Carolina,8,7,Memphis,1
2021-04-11,@East Carolina,7,1,Memphis,6
2021-04-23,@East Carolina,4,2,Central Florida,2
2021-04-23,@East Carolina,5,10,Central Florida,-5
2021-04-24,@East Carolina,11,8,Central Florida,3
2021-04-25,@East Carolina,1,6,Central Florida,-5
2021-04-30,@Wichita State,10,0,Wichita State,10
2021-04-30,@Wichita State,2,12,Wichita State,-10
2021-05-01,@Wichita State,11,3,Wichita State,8
2021-05-02,@Wichita State,9,11,Wichita State,-2
2021-05-07,@East Carolina,12,4,Tulane,8
2021-05-08,@East Carolina,7,4,Tulane,3
2021-05-08,@East Carolina,6,7,Tulane,-1
2021-05-09,@East Carolina,9,1,Tulane,8
2021-05-14,@Cincinnati,8,4,Cincinnati,4
2021-05-14,@Cincinnati,6,7,Cincinnati,-1
2021-05-15,@Cincinnati,7,6,Cincinnati,1
2021-05-16,@Cincinnati,5,2,Cincinnati,3
2021-05-20,@South Florida,5,2,South Florida,3
2021-05-20,@South Florida,10,1,South Florida,9
2021-05-21,@South Florida,0,7,South Florida,-7
2021-05-22,@South Florida,2,8,South Florida,-6
2021-05-25,@East Carolina,1,11,Memphis,-10
2021-05-26,@East Carolina,13,9,Cincinnati,4
2021-05-28,@East Carolina,12,0,Memphis,12
2021-05-29,@East Carolina,1,2,Central Florida,-1
2021-05-29,@East Carolina,5,2,Central Florida,3
2021-06-04,@East Carolina,8,5,Norfolk State,3
2021-06-05,@East Carolina,7,5,North Carolina-Charlotte,2
2021-06-06,@Maryland,9,6,Maryland,3
2021-06-11,@Vanderbilt,0,2,Vanderbilt,-2
2021-06-12,@East Carolina,1,4,Vanderbilt,-3
2021-02-20,@Nicholls State,4,3,Nicholls State,1
2021-02-20,@Nicholls State,4,11,Nicholls State,-7
2021-02-21,@Nicholls State,3,2,Nicholls State,1
2021-02-23,@Southern Illinois,9,10,Southern Illinois,-1
2021-02-26,@Arkansas-Little Rock,12,6,Arkansas-Little Rock,6
2021-02-26,@Arkansas-Little Rock,17,1,Arkansas-Little Rock,16
2021-02-27,@Arkansas-Little Rock,5,6,Arkansas-Little Rock,-1
2021-03-02,@Bellarmine,1,11,Bellarmine,-10
2021-03-02,@Bellarmine,13,10,Bellarmine,3
2021-03-05,@Kansas State,3,6,Kansas State,-3
2021-03-06,@Kansas State,6,5,Kansas State,1
2021-03-07,@Kansas State,14,7,Kansas State,7
2021-03-09,@Eastern Illinois,8,1,Bellarmine,7
2021-03-12,@Eastern Illinois,2,9,Murray State,-7
2021-03-13,@Eastern Illinois,14,10,Murray State,4
2021-03-13,@Eastern Illinois,5,15,Murray State,-10
2021-03-20,@Tennessee Tech,18,6,Tennessee Tech,12
2021-03-20,@Tennessee Tech,8,9,Tennessee Tech,-1
2021-03-21,@Tennessee Tech,1,9,Tennessee Tech,-8
2021-03-24,@Illinois State,9,7,Illinois State,2
2021-03-26,@Eastern Illinois,2,3,Southeast Missouri State,-1
2021-03-27,@Eastern Illinois,9,2,Southeast Missouri State,7
2021-03-27,@Eastern Illinois,8,4,Southeast Missouri State,4
2021-03-30,@Eastern Illinois,3,4,Illinois State,-1
2021-04-02,@Belmont,5,2,Belmont,3
2021-04-03,@Belmont,2,10,Belmont,-8
2021-04-03,@Belmont,6,10,Belmont,-4
2021-04-09,@Eastern Illinois,9,7,Eastern Kentucky,2
2021-04-09,@Eastern Illinois,11,2,Eastern Kentucky,9
2021-04-10,@Eastern Illinois,6,8,Eastern Kentucky,-2
2021-04-13,@Eastern Illinois,10,3,Maryville,7
2021-04-16,@Morehead State,9,11,Morehead State,-2
2021-04-16,@Morehead State,4,7,Morehead State,-3
2021-04-17,@Morehead State,8,6,Morehead State,2
2021-04-18,@Morehead State,4,14,Morehead State,-10
2021-04-22,@Eastern Illinois,1,5,Tennessee-Martin,-4
2021-04-23,@Eastern Illinois,2,5,Tennessee-Martin,-3
2021-04-23,@Eastern Illinois,7,0,Tennessee-Martin,7
2021-04-30,@Southern Illinois-Edwardsville,4,3,Southern Illinois-Edwardsville,1
2021-05-01,@Southern Illinois-Edwardsville,15,10,Southern Illinois-Edwardsville,5
2021-05-01,@Southern Illinois-Edwardsville,5,7,Southern Illinois-Edwardsville,-2
2021-05-07,@Eastern Illinois,5,7,Austin Peay State,-2
2021-05-07,@Eastern Illinois,7,4,Austin Peay State,3
2021-05-08,@Eastern Illinois,8,7,Austin Peay State,1
2021-05-17,@Eastern Illinois,5,4,Southern Illinois-Edwardsville,1
2021-05-20,@Jacksonville State,7,4,Jacksonville State,3
2021-05-21,@Jacksonville State,0,10,Jacksonville State,-10
2021-05-21,@Jacksonville State,2,4,Jacksonville State,-2
2021-02-19,@Georgia Tech,6,12,Georgia Tech,-6
2021-02-20,@Georgia Tech,9,6,Georgia Tech,3
2021-02-21,@Georgia Tech,1,7,Georgia Tech,-6
2021-02-23,@Louisville,2,6,Louisville,-4
2021-02-27,@Eastern Kentucky,5,3,Presbyterian,2
2021-02-27,@Eastern Kentucky,9,12,Presbyterian,-3
2021-03-02,@Kentucky,3,6,Kentucky,-3
2021-03-05,@East Tennessee State,6,7,East Tennessee State,-1
2021-03-06,@East Tennessee State,9,7,East Tennessee State,2
2021-03-06,@East Tennessee State,2,3,East Tennessee State,-1
2021-03-09,@Eastern Kentucky,2,1,Marshall,1
2021-03-12,@Morehead State,2,5,Morehead State,-3
2021-03-13,@Morehead State,5,14,Morehead State,-9
2021-03-13,@Morehead State,11,0,Morehead State,11
2021-03-16,@Eastern Kentucky,6,3,Louisville,3
2021-03-20,@Eastern Kentucky,6,1,Tennessee-Martin,5
2021-03-20,@Eastern Kentucky,3,7,Tennessee-Martin,-4
2021-03-21,@Eastern Kentucky,3,2,Tennessee-Martin,1
2021-03-23,@Tennessee,5,13,Tennessee,-8
2021-03-24,@Eastern Kentucky,13,20,Dayton,-7
2021-03-26,@Southern Illinois-Edwardsville,9,11,Southern Illinois-Edwardsville,-2
2021-03-27,@Southern Illinois-Edwardsville,3,12,Southern Illinois-Edwardsville,-9
2021-03-27,@Southern Illinois-Edwardsville,5,8,Southern Illinois-Edwardsville,-3
2021-04-02,@Eastern Kentucky,9,15,Austin Peay State,-6
2021-04-03,@Eastern Kentucky,1,3,Austin Peay State,-2
2021-04-03,@Eastern Kentucky,9,4,Austin Peay State,5
2021-04-06,@Tennessee,1,10,Tennessee,-9
2021-04-09,@Eastern Illinois,7,9,Eastern Illinois,-2
2021-04-09,@Eastern Illinois,2,11,Eastern Illinois,-9
2021-04-10,@Eastern Illinois,8,6,Eastern Illinois,2
2021-04-13,@Vanderbilt,4,6,Vanderbilt,-2
2021-04-16,@Eastern Kentucky,1,0,Jacksonville State,1
2021-04-17,@Eastern Kentucky,9,5,Jacksonville State,4
2021-04-17,@Eastern Kentucky,1,11,Jacksonville State,-10
2021-04-20,@Eastern Kentucky,13,4,Morehead State,9
2021-04-23,@Murray State,3,6,Murray State,-3
2021-04-23,@Murray State,8,10,Murray State,-2
2021-04-24,@Murray State,3,7,Murray State,-4
2021-04-27,@Kentucky,6,7,Kentucky,-1
2021-04-30,@Eastern Kentucky,10,5,Tennessee Tech,5
2021-05-01,@Eastern Kentucky,9,3,Tennessee Tech,6
2021-05-01,@Eastern Kentucky,3,16,Tennessee Tech,-13
2021-05-07,@Southeast Missouri State,2,6,Southeast Missouri State,-4
2021-05-07,@Southeast Missouri State,8,0,Southeast Missouri State,8
2021-05-08,@Southeast Missouri State,6,7,Southeast Missouri State,-1
2021-05-11,@Eastern Kentucky,3,2,Bellarmine,1
2021-05-14,@Eastern Kentucky,8,1,Belmont,7
2021-05-15,@Eastern Kentucky,3,2,Belmont,1
2021-05-15,@Eastern Kentucky,6,4,Belmont,2
2021-05-18,@Western Kentucky,3,4,Western Kentucky,-1
2021-05-20,@Eastern Kentucky,15,3,North Dakota State,12
2021-05-21,@Eastern Kentucky,1,8,North Dakota State,-7
2021-05-22,@Eastern Kentucky,1,6,North Dakota State,-5
2021-02-27,@Alabama State,2,1,Alabama State,1
2021-02-28,@Alabama State,4,3,Alabama State,1
2021-03-05,@Bellarmine,7,2,Bellarmine,5
2021-03-06,@Bellarmine,12,6,Bellarmine,6
2021-03-06,@Bellarmine,1,2,Bellarmine,-1
2021-03-07,@Bellarmine,10,11,Bellarmine,-1
2021-03-12,@Mississippi State,0,14,Mississippi State,-14
2021-03-13,@Mississippi State,1,4,Mississippi State,-3
2021-03-14,@Mississippi State,1,4,Mississippi State,-3
2021-03-19,@Akron,9,2,Akron,7
2021-03-20,@Akron,2,3,Akron,-1
2021-03-20,@Akron,6,8,Akron,-2
2021-03-21,@Akron,8,6,Akron,2
2021-03-27,@Western Michigan,9,4,Western Michigan,5
2021-03-28,@Western Michigan,1,8,Western Michigan,-7
2021-03-29,@Western Michigan,5,4,Western Michigan,1
2021-03-29,@Western Michigan,1,3,Western Michigan,-2
2021-04-02,@Eastern Michigan,3,4,"Miami, Ohio",-1
2021-04-03,@Eastern Michigan,0,5,"Miami, Ohio",-5
2021-04-03,@Eastern Michigan,1,4,"Miami, Ohio",-3
2021-04-04,@Eastern Michigan,4,5,"Miami, Ohio",-1
2021-04-09,@Ohio,3,6,Ohio,-3
2021-04-10,@Ohio,1,2,Ohio,-1
2021-04-10,@Ohio,3,4,Ohio,-1
2021-04-11,@Ohio,2,3,Ohio,-1
2021-04-16,@Eastern Michigan,10,6,Ball State,4
2021-04-17,@Eastern Michigan,8,13,Ball State,-5
2021-04-17,@Eastern Michigan,2,1,Ball State,1
2021-04-18,@Eastern Michigan,2,5,Ball State,-3
2021-05-01,@St. Bonaventure,13,2,St. Bonaventure,11
2021-05-01,@St. Bonaventure,20,5,St. Bonaventure,15
2021-05-04,@Eastern Michigan,13,2,Toledo,11
2021-05-07,@Bowling Green State,8,0,Bowling Green State,8
2021-05-07,@Bowling Green State,10,8,Bowling Green State,2
2021-05-08,@Bowling Green State,6,5,Bowling Green State,1
2021-05-08,@Bowling Green State,3,0,Bowling Green State,3
2021-05-11,@Eastern Michigan,6,0,Toledo,6
2021-05-11,@Eastern Michigan,2,10,Toledo,-8
2021-05-14,@Eastern Michigan,10,4,Northern Illinois,6
2021-05-15,@Eastern Michigan,3,2,Northern Illinois,1
2021-05-15,@Eastern Michigan,3,5,Northern Illinois,-2
2021-05-16,@Eastern Michigan,5,8,Northern Illinois,-3
2021-05-18,@Eastern Michigan,10,16,Toledo,-6
2021-05-21,@Central Michigan,0,14,Central Michigan,-14
2021-05-22,@Central Michigan,0,1,Central Michigan,-1
2021-05-22,@Central Michigan,2,4,Central Michigan,-2
2021-05-23,@Central Michigan,4,8,Central Michigan,-4
2021-05-28,@Eastern Michigan,5,4,Kent State,1
2021-05-29,@Eastern Michigan,3,4,Kent State,-1
2021-05-29,@Eastern Michigan,5,9,Kent State,-4
2021-05-30,@Eastern Michigan,2,4,Kent State,-2
2021-02-19,@North Carolina-Greensboro,7,4,North Carolina-Greensboro,3
2021-02-20,@North Carolina-Greensboro,3,8,North Carolina-Greensboro,-5
2021-02-21,@North Carolina-Greensboro,2,3,North Carolina-Greensboro,-1
2021-02-23,@North Carolina,1,4,North Carolina,-3
2021-02-27,@Elon,3,4,Virginia Commonwealth,-1
2021-02-27,@Elon,7,6,Virginia Commonwealth,1
2021-02-28,@Elon,8,7,Virginia Commonwealth,1
2021-03-05,@Elon,3,7,North Carolina-Greensboro,-4
2021-03-06,@North Carolina-Greensboro,3,9,North Carolina-Greensboro,-6
2021-03-07,@Elon,6,14,North Carolina-Greensboro,-8
2021-03-12,@North Carolina A&T,7,8,North Carolina A&T,-1
2021-03-13,@North Carolina A&T,10,4,North Carolina A&T,6
2021-03-14,@Elon,10,9,North Carolina A&T,1
2021-03-23,@Elon,2,4,Wake Forest,-2
2021-03-26,@Elon,0,15,East Carolina,-15
2021-03-27,@Elon,2,1,East Carolina,1
2021-03-30,@Elon,3,6,Virginia Commonwealth,-3
2021-04-02,@North Carolina-Wilmington,4,6,North Carolina-Wilmington,-2
2021-04-03,@North Carolina-Wilmington,5,4,North Carolina-Wilmington,1
2021-04-04,@North Carolina-Wilmington,2,8,North Carolina-Wilmington,-6
2021-04-06,@Elon,8,7,High Point,1
2021-04-10,@Elon,7,6,William and Mary,1
2021-04-10,@Elon,13,7,William and Mary,6
2021-04-11,@Elon,8,0,William and Mary,8
2021-04-17,@William and Mary,4,6,William and Mary,-2
2021-04-17,@William and Mary,9,12,William and Mary,-3
2021-04-18,@William and Mary,7,9,William and Mary,-2
2021-04-23,@Elon,2,1,North Carolina-Wilmington,1
2021-04-25,@Elon,5,6,North Carolina-Wilmington,-1
2021-04-25,@Elon,7,6,North Carolina-Wilmington,1
2021-04-28,@Elon,4,3,Western Carolina,1
2021-04-30,@Elon,14,5,College of Charleston,9
2021-05-01,@Elon,12,11,College of Charleston,1
2021-05-02,@Elon,3,6,College of Charleston,-3
2021-05-08,@Wake Forest,5,2,Wake Forest,3
2021-05-13,@Elon,8,5,Georgia Southern,3
2021-05-14,@Elon,6,4,Georgia Southern,2
2021-05-15,@Elon,5,7,Georgia Southern,-2
2021-05-20,@College of Charleston,10,7,College of Charleston,3
2021-05-21,@College of Charleston,6,7,College of Charleston,-1
2021-05-22,@College of Charleston,9,7,College of Charleston,2
2021-05-26,@Elon,7,3,William and Mary,4
2021-05-27,@North Carolina-Wilmington,0,2,North Carolina-Wilmington,-2
2021-05-28,@College of Charleston,2,6,College of Charleston,-4
2021-02-19,@Georgia,3,2,Georgia,1
2021-02-20,@Georgia,3,7,Georgia,-4
2021-02-20,@Georgia,5,6,Georgia,-1
2021-02-21,@Georgia,1,4,Georgia,-3
2021-02-26,@Evansville,5,4,Northern Illinois,1
2021-02-27,@Evansville,8,5,Northern Illinois,3
2021-02-28,@Evansville,4,7,Northern Illinois,-3
2021-03-03,@Kentucky,5,8,Kentucky,-3
2021-03-05,@Evansville,11,0,Western Illinois,11
2021-03-06,@Evansville,3,2,Western Illinois,1
2021-03-06,@Evansville,6,7,Western Illinois,-1
2021-03-07,@Evansville,11,10,Western Illinois,1
2021-03-12,@Southern Illinois,5,14,Southern Illinois,-9
2021-03-13,@Southern Illinois,4,9,Southern Illinois,-5
2021-03-13,@Southern Illinois,3,5,Southern Illinois,-2
2021-03-14,@Southern Illinois,7,3,Southern Illinois,4
2021-03-19,@Evansville,7,0,Butler,7
2021-03-20,@Evansville,8,12,Butler,-4
2021-03-21,@Evansville,10,1,Butler,9
2021-03-26,@Evansville,1,6,Xavier,-5
2021-03-27,@Evansville,1,0,Xavier,1
2021-03-27,@Evansville,7,4,Xavier,3
2021-03-28,@Evansville,9,2,Xavier,7
2021-04-02,@Evansville,13,3,South Dakota State,10
2021-04-03,@Evansville,11,1,South Dakota State,10
2021-04-03,@Evansville,3,2,South Dakota State,1
2021-04-04,@Evansville,14,8,South Dakota State,6
2021-04-09,@Bradley,5,3,Bradley,2
2021-04-11,@Bradley,4,5,Bradley,-1
2021-04-11,@Bradley,4,2,Bradley,2
2021-04-16,@Evansville,3,5,Missouri State,-2
2021-04-17,@Evansville,0,3,Missouri State,-3
2021-04-17,@Evansville,4,2,Missouri State,2
2021-04-18,@Evansville,5,9,Missouri State,-4
2021-04-23,@Illinois State,12,0,Illinois State,12
2021-04-24,@Illinois State,3,6,Illinois State,-3
2021-04-24,@Illinois State,7,8,Illinois State,-1
2021-04-25,@Illinois State,1,3,Illinois State,-2
2021-04-30,@Evansville,1,2,Dallas Baptist,-1
2021-05-01,@Evansville,5,6,Dallas Baptist,-1
2021-05-01,@Evansville,4,3,Dallas Baptist,1
2021-05-02,@Evansville,1,20,Dallas Baptist,-19
2021-05-07,@Evansville,7,16,Southern Illinois,-9
2021-05-07,@Evansville,8,6,Southern Illinois,2
2021-05-08,@Evansville,0,5,Southern Illinois,-5
2021-05-09,@Evansville,6,5,Southern Illinois,1
2021-05-14,@Valparaiso,13,6,Valparaiso,7
2021-05-15,@Valparaiso,12,9,Valparaiso,3
2021-05-15,@Valparaiso,1,5,Valparaiso,-4
2021-05-16,@Valparaiso,11,9,Valparaiso,2
2021-05-20,@Evansville,7,14,Indiana State,-7
2021-05-21,@Evansville,5,4,Indiana State,1
2021-05-21,@Evansville,5,1,Indiana State,4
2021-05-22,@Evansville,10,13,Indiana State,-3
2021-05-25,@Illinois State,9,10,Illinois State,-1
2021-03-20,@Fairfield,13,4,Canisius,9
2021-03-20,@Fairfield,7,4,Canisius,3
2021-03-21,@Fairfield,6,3,Canisius,3
2021-03-21,@Fairfield,8,0,Canisius,8
2021-04-02,@Fairfield,4,2,Iona,2
2021-04-02,@Fairfield,4,2,Iona,2
2021-04-03,@Fairfield,10,2,Iona,8
2021-04-03,@Fairfield,7,0,Iona,7
2021-04-07,@Fairfield,6,3,Quinnipiac,3
2021-04-07,@Fairfield,17,6,Quinnipiac,11
2021-04-09,@Fairfield,10,0,Rider,10
2021-04-09,@Fairfield,8,3,Rider,5
2021-04-10,@Fairfield,5,0,Rider,5
2021-04-10,@Fairfield,6,0,Rider,6
2021-04-14,@Fairfield,2,1,Quinnipiac,1
2021-04-14,@Fairfield,5,2,Quinnipiac,3
2021-04-17,@Fairfield,3,2,Monmouth,1
2021-04-17,@Fairfield,8,2,Monmouth,6
2021-04-18,@Fairfield,4,1,Monmouth,3
2021-04-18,@Fairfield,4,3,Monmouth,1
2021-04-21,@St. Peter's,9,0,St. Peter's,9
2021-04-21,@St. Peter's,20,2,St. Peter's,18
2021-04-23,@Manhattan,12,4,Manhattan,8
2021-04-23,@Manhattan,16,4,Manhattan,12
2021-04-24,@Manhattan,19,9,Manhattan,10
2021-04-24,@Manhattan,8,4,Manhattan,4
2021-05-01,@Fairfield,10,0,Siena,10
2021-05-01,@Fairfield,2,1,Siena,1
2021-05-02,@Fairfield,1,6,Siena,-5
2021-05-02,@Fairfield,4,0,Siena,4
2021-05-08,@Niagara,4,1,Niagara,3
2021-05-08,@Niagara,1,0,Niagara,1
2021-05-09,@Niagara,10,8,Niagara,2
2021-05-09,@Niagara,8,5,Niagara,3
2021-05-20,@Fairfield,2,1,Manhattan,1
2021-05-20,@Fairfield,2,1,Manhattan,1
2021-05-26,@Fairfield,1,4,Canisius,-3
2021-05-27,@Fairfield,3,1,Monmouth,2
2021-05-28,@Fairfield,8,2,Canisius,6
2021-05-28,@Fairfield,2,7,Rider,-5
2021-06-04,@Arizona State,6,7,Arizona State,-1
2021-06-05,@Fairfield,6,2,Southern,4
2021-06-06,@Fairfield,9,7,Arizona State,2
2021-06-06,@Fairfield,2,12,Texas,-10
2021-03-10,@LIU-Brooklyn,0,12,LIU-Brooklyn,-12
2021-03-12,@Fordham,0,9,Fordham,-9
2021-03-13,@Fordham,4,2,Fordham,2
2021-03-14,@Fordham,2,6,Fordham,-4
2021-03-17,@Fairleigh Dickinson,5,6,LIU-Brooklyn,-1
2021-03-19,@Fairleigh Dickinson,3,17,Wagner,-14
2021-03-20,@Fairleigh Dickinson,7,3,Wagner,4
2021-03-21,@Fairleigh Dickinson,4,6,Wagner,-2
2021-03-26,@Fairleigh Dickinson,7,21,Central Connecticut State,-14
2021-03-27,@Fairleigh Dickinson,5,2,Central Connecticut State,3
2021-03-27,@Fairleigh Dickinson,5,9,Central Connecticut State,-4
2021-04-01,@LIU-Brooklyn,2,3,LIU-Brooklyn,-1
2021-04-02,@LIU-Brooklyn,5,14,LIU-Brooklyn,-9
2021-04-03,@LIU-Brooklyn,2,9,LIU-Brooklyn,-7
2021-04-10,@Bryant,10,19,Bryant,-9
2021-04-10,@Bryant,0,14,Bryant,-14
2021-04-11,@Bryant,8,9,Bryant,-1
2021-04-16,@Fairleigh Dickinson,10,4,Mount St. Mary's,6
2021-04-17,@Fairleigh Dickinson,3,14,Mount St. Mary's,-11
2021-04-18,@Fairleigh Dickinson,8,6,Mount St. Mary's,2
2021-04-20,@Fairleigh Dickinson,10,11,Wagner,-1
2021-04-23,@Fairleigh Dickinson,4,1,Merrimack,3
2021-04-24,@Fairleigh Dickinson,2,7,Merrimack,-5
2021-04-24,@Fairleigh Dickinson,6,7,Merrimack,-1
2021-04-28,@Lehigh,6,7,Lehigh,-1
2021-04-30,@Sacred Heart,7,12,Sacred Heart,-5
2021-05-01,@Sacred Heart,4,14,Sacred Heart,-10
2021-05-02,@Sacred Heart,3,7,Sacred Heart,-4
2021-05-07,@Fairleigh Dickinson,3,2,Wagner,1
2021-05-08,@Fairleigh Dickinson,1,5,Wagner,-4
2021-05-09,@Fairleigh Dickinson,6,5,Wagner,1
2021-05-14,@Fairleigh Dickinson,5,7,LIU-Brooklyn,-2
2021-05-15,@Fairleigh Dickinson,2,18,LIU-Brooklyn,-16
2021-05-16,@Fairleigh Dickinson,6,26,LIU-Brooklyn,-20
2021-05-20,@Central Connecticut State,0,6,Central Connecticut State,-6
2021-05-21,@Central Connecticut State,3,1,Central Connecticut State,2
2021-05-21,@Central Connecticut State,12,14,Central Connecticut State,-2
2021-02-19,@Florida,7,5,"Miami, Florida",2
2021-02-20,@Florida,9,10,"Miami, Florida",-1
2021-02-21,@Florida,6,8,"Miami, Florida",-2
2021-02-23,@North Florida,9,6,North Florida,3
2021-02-24,@Florida,8,3,North Florida,5
2021-02-26,@Florida,8,4,Samford,4
2021-02-27,@Florida,18,2,Samford,16
2021-02-28,@Florida,10,9,Samford,1
2021-03-03,@Florida,2,3,Florida Atlantic,-1
2021-03-05,@Florida,10,2,Florida A&M,8
2021-03-05,@Florida,5,1,Florida A&M,4
2021-03-07,@Florida,8,0,Florida A&M,8
2021-03-09,@Florida,5,1,Georgia State,4
2021-03-10,@Florida,10,7,Stetson,3
2021-03-12,@Florida,9,10,Jacksonville,-1
2021-03-13,@Florida,9,0,Jacksonville,9
2021-03-14,@Florida,5,2,Jacksonville,3
2021-03-16,@Florida State,2,10,Florida State,-8
2021-03-18,@Florida,13,4,Texas A&M,9
2021-03-19,@Florida,3,1,Texas A&M,2
2021-03-20,@Florida,8,4,Texas A&M,4
2021-03-26,@South Carolina,8,9,South Carolina,-1
2021-03-27,@South Carolina,1,4,South Carolina,-3
2021-03-28,@South Carolina,5,8,South Carolina,-3
2021-04-01,@Florida,4,1,Mississippi,3
2021-04-02,@Florida,2,8,Mississippi,-6
2021-04-03,@Florida,6,5,Mississippi,1
2021-04-06,@Florida,7,6,Stetson,1
2021-04-07,@Florida,10,0,Florida A&M,10
2021-04-09,@Tennessee,4,6,Tennessee,-2
2021-04-10,@Tennessee,4,5,Tennessee,-1
2021-04-11,@Tennessee,7,6,Tennessee,1
2021-04-13,@Florida,3,2,Florida State,1
2021-04-16,@Florida,8,5,Missouri,3
2021-04-17,@Florida,8,6,Missouri,2
2021-04-17,@Florida,6,4,Missouri,2
2021-04-20,@Jacksonville,8,7,Jacksonville,1
2021-04-23,@Auburn,4,2,Auburn,2
2021-04-25,@Auburn,6,4,Auburn,2
2021-04-25,@Auburn,8,10,Auburn,-2
2021-04-30,@Florida,7,11,Vanderbilt,-4
2021-05-01,@Florida,11,8,Vanderbilt,3
2021-05-02,@Florida,5,3,Vanderbilt,2
2021-05-04,@Florida,9,6,Stetson,3
2021-05-06,@Kentucky,5,7,Kentucky,-2
2021-05-07,@Kentucky,8,5,Kentucky,3
2021-05-08,@Kentucky,9,2,Kentucky,7
2021-05-11,@Stetson,1,6,Stetson,-5
2021-05-14,@Florida,4,3,Georgia,1
2021-05-15,@Florida,9,2,Georgia,7
2021-05-16,@Florida,1,6,Georgia,-5
2021-05-20,@Arkansas,1,6,Arkansas,-5
2021-05-21,@Arkansas,3,4,Arkansas,-1
2021-05-22,@Arkansas,3,9,Arkansas,-6
2021-05-25,@Florida,4,1,Kentucky,3
2021-05-26,@Mississippi State,13,1,Mississippi State,12
2021-05-27,@Alabama,7,2,Alabama,5
2021-05-29,@Florida,0,4,Tennessee,-4
2021-06-04,@Florida,3,5,South Florida,-2
2021-06-05,@South Alabama,1,19,South Alabama,-18
2021-02-20,@Stetson,3,6,Stetson,-3
2021-02-20,@Stetson,0,1,Stetson,-1
2021-02-21,@Stetson,0,6,Stetson,-6
2021-02-21,@Stetson,1,3,Stetson,-2
2021-02-26,@South Florida,1,3,South Florida,-2
2021-02-26,@South Florida,0,13,South Florida,-13
2021-02-27,@South Florida,4,9,South Florida,-5
2021-02-28,@South Florida,8,9,South Florida,-1
2021-03-05,@Florida,1,5,Florida,-4
2021-03-05,@Florida,2,10,Florida,-8
2021-03-07,@Florida,0,8,Florida,-8
2021-03-10,@Mercer,3,10,Mercer,-7
2021-03-12,@Florida A&M,7,4,Grambling State,3
2021-03-13,@Grambling State,3,1,Grambling State,2
2021-03-14,@Florida A&M,10,8,Grambling State,2
2021-03-16,@Florida A&M,4,13,Mercer,-9
2021-03-17,@Florida A&M,6,10,Mercer,-4
2021-03-19,@Florida A&M,9,6,Florida Gulf Coast,3
2021-03-20,@Florida A&M,3,1,Florida Gulf Coast,2
2021-03-20,@Florida A&M,4,9,Florida Gulf Coast,-5
2021-03-21,@Florida A&M,2,3,Florida Gulf Coast,-1
2021-03-26,@Florida A&M,4,1,North Carolina A&T,3
2021-03-27,@Florida A&M,4,3,North Carolina A&T,1
2021-03-27,@Florida A&M,6,4,North Carolina A&T,2
2021-03-28,@Florida A&M,12,7,North Carolina A&T,5
2021-03-30,@Florida A&M,15,14,Alabama State,1
2021-04-07,@Florida,0,10,Florida,-10
2021-04-10,@Florida A&M,12,5,Norfolk State,7
2021-04-10,@Florida A&M,6,2,Norfolk State,4
2021-04-11,@Florida A&M,4,7,Norfolk State,-3
2021-04-11,@Florida A&M,2,6,Norfolk State,-4
2021-04-13,@Alabama State,6,7,Alabama State,-1
2021-04-16,@North Carolina A&T,2,8,North Carolina A&T,-6
2021-04-17,@North Carolina A&T,5,10,North Carolina A&T,-5
2021-04-17,@North Carolina A&T,13,5,North Carolina A&T,8
2021-04-18,@North Carolina A&T,2,5,North Carolina A&T,-3
2021-04-23,@Florida A&M,0,3,North Carolina Central,-3
2021-04-23,@Florida A&M,8,3,North Carolina Central,5
2021-04-25,@Florida A&M,4,5,North Carolina Central,-1
2021-04-25,@Florida A&M,4,2,North Carolina Central,2
2021-04-28,@North Florida,6,16,North Florida,-10
2021-04-30,@Norfolk State,1,9,Norfolk State,-8
2021-05-01,@Norfolk State,5,4,Norfolk State,1
2021-05-01,@Norfolk State,12,4,Norfolk State,8
2021-05-02,@Norfolk State,5,2,Norfolk State,3
2021-05-07,@Florida A&M,7,6,North Carolina A&T,1
2021-05-08,@Florida A&M,5,3,North Carolina A&T,2
2021-05-08,@Florida A&M,2,1,North Carolina A&T,1
2021-05-09,@Florida A&M,9,11,North Carolina A&T,-2
2021-05-13,@North Carolina Central,4,10,North Carolina Central,-6
2021-05-14,@North Carolina Central,1,4,North Carolina Central,-3
2021-05-14,@North Carolina Central,0,5,North Carolina Central,-5
2021-05-15,@North Carolina Central,1,6,North Carolina Central,-5
2021-05-20,@Norfolk State,3,8,Norfolk State,-5
2021-05-21,@Florida A&M,14,13,Delaware State,1
2021-05-21,@North Carolina Central,3,5,North Carolina Central,-2
2021-02-19,@Central Florida,12,6,Central Florida,6
2021-02-20,@Florida Atlantic,20,15,Central Florida,5
2021-02-21,@Florida Atlantic,6,15,Central Florida,-9
2021-02-23,@Florida Gulf Coast,3,1,Florida Gulf Coast,2
2021-02-26,@Florida Atlantic,6,2,Seton Hall,4
2021-02-27,@Florida Atlantic,17,14,Seton Hall,3
2021-02-28,@Florida Atlantic,10,4,Seton Hall,6
2021-03-03,@Florida,3,2,Florida,1
2021-03-05,@Florida Atlantic,0,8,Florida Gulf Coast,-8
2021-03-07,@Florida Atlantic,14,9,Florida Gulf Coast,5
2021-03-09,"@Miami, Florida",2,11,"Miami, Florida",-9
2021-03-11,@Florida Atlantic,5,7,Indiana State,-2
2021-03-12,@Florida Atlantic,2,10,Indiana State,-8
2021-03-13,@Florida Atlantic,7,5,Indiana State,2
2021-03-16,@Central Florida,3,8,Central Florida,-5
2021-03-19,@South Florida,5,1,South Florida,4
2021-03-20,@South Florida,0,4,South Florida,-4
2021-03-21,@South Florida,5,6,South Florida,-1
2021-03-23,@Florida Atlantic,9,14,"Miami, Florida",-5
2021-03-26,@Florida Atlantic,12,0,Marshall,12
2021-03-27,@Florida Atlantic,5,3,Marshall,2
2021-03-27,@Florida Atlantic,7,6,Marshall,1
2021-03-28,@Florida Atlantic,11,2,Marshall,9
2021-03-30,@Florida Gulf Coast,13,11,Florida Gulf Coast,2
2021-04-02,@North Carolina-Charlotte,5,9,North Carolina-Charlotte,-4
2021-04-03,@North Carolina-Charlotte,4,5,North Carolina-Charlotte,-1
2021-04-03,@North Carolina-Charlotte,8,9,North Carolina-Charlotte,-1
2021-04-04,@North Carolina-Charlotte,10,11,North Carolina-Charlotte,-1
2021-04-09,@Florida Atlantic,2,7,Old Dominion,-5
2021-04-10,@Florida Atlantic,3,10,Old Dominion,-7
2021-04-10,@Florida Atlantic,2,8,Old Dominion,-6
2021-04-11,@Florida Atlantic,4,0,Old Dominion,4
2021-04-16,@Alabama-Birmingham,6,7,Alabama-Birmingham,-1
2021-04-17,@Alabama-Birmingham,2,1,Alabama-Birmingham,1
2021-04-17,@Alabama-Birmingham,2,4,Alabama-Birmingham,-2
2021-04-18,@Alabama-Birmingham,5,3,Alabama-Birmingham,2
2021-04-23,@Florida International,11,6,Florida International,5
2021-04-24,@Florida International,5,6,Florida International,-1
2021-04-24,@Florida International,16,7,Florida International,9
2021-04-25,@Florida International,8,7,Florida International,1
2021-05-01,@Florida Atlantic,12,2,Florida International,10
2021-05-01,@Florida Atlantic,1,6,Florida International,-5
2021-05-02,@Florida Atlantic,9,8,Florida International,1
2021-05-02,@Florida Atlantic,3,1,Florida International,2
2021-05-07,@Western Kentucky,5,6,Western Kentucky,-1
2021-05-07,@Western Kentucky,6,3,Western Kentucky,3
2021-05-08,@Western Kentucky,6,3,Western Kentucky,3
2021-05-08,@Western Kentucky,6,1,Western Kentucky,5
2021-05-14,@Florida Atlantic,3,1,Southern Mississippi,2
2021-05-15,@Florida Atlantic,8,14,Southern Mississippi,-6
2021-05-15,@Florida Atlantic,1,6,Southern Mississippi,-5
2021-05-16,@Florida Atlantic,9,6,Southern Mississippi,3
2021-05-18,"@Miami, Florida",3,0,"Miami, Florida",3
2021-05-26,@Old Dominion,2,11,Old Dominion,-9
2021-05-27,@North Carolina-Charlotte,9,8,North Carolina-Charlotte,1
2021-05-28,@Florida Atlantic,14,8,Middle Tennessee State,6
2021-05-29,@Old Dominion,5,13,Old Dominion,-8
2021-02-20,@South Florida,11,6,South Florida,5
2021-02-20,@South Florida,4,1,South Florida,3
2021-02-21,@Florida Gulf Coast,12,10,South Florida,2
2021-02-23,@Florida Gulf Coast,1,3,Florida Atlantic,-2
2021-02-26,@Florida Gulf Coast,3,5,Kansas,-2
2021-02-27,@Florida Gulf Coast,6,5,Kansas,1
2021-02-28,@Florida Gulf Coast,2,0,Kansas,2
2021-02-28,@Florida Gulf Coast,3,2,Kansas,1
2021-03-05,@Florida Atlantic,8,0,Florida Atlantic,8
2021-03-07,@Florida Atlantic,9,14,Florida Atlantic,-5
2021-03-09,@Florida Gulf Coast,3,5,Indiana State,-2
2021-03-12,@Florida Gulf Coast,7,1,South Florida,6
2021-03-13,@South Florida,6,5,South Florida,1
2021-03-14,@Florida Gulf Coast,17,13,South Florida,4
2021-03-17,@Florida Gulf Coast,2,15,"Miami, Florida",-13
2021-03-19,@Florida A&M,6,9,Florida A&M,-3
2021-03-20,@Florida A&M,9,4,Florida A&M,5
2021-03-20,@Florida A&M,1,3,Florida A&M,-2
2021-03-21,@Florida A&M,3,2,Florida A&M,1
2021-03-26,@Stetson,5,7,Stetson,-2
2021-03-27,@Stetson,13,6,Stetson,7
2021-03-28,@Stetson,4,13,Stetson,-9
2021-03-30,@Florida Gulf Coast,11,13,Florida Atlantic,-2
2021-04-01,@North Florida,12,11,North Florida,1
2021-04-02,@North Florida,6,5,North Florida,1
2021-04-03,@North Florida,7,5,North Florida,2
2021-04-09,@Florida Gulf Coast,18,4,Jacksonville,14
2021-04-10,@Florida Gulf Coast,14,8,Jacksonville,6
2021-04-10,@Florida Gulf Coast,9,7,Jacksonville,2
2021-04-14,"@Miami, Florida",2,3,"Miami, Florida",-1
2021-04-16,@Wright State,3,10,Wright State,-7
2021-04-16,@Florida Gulf Coast,13,12,Wright State,1
2021-04-17,@Florida Gulf Coast,6,4,Wright State,2
2021-04-23,@Florida Gulf Coast,4,3,Stetson,1
2021-04-24,@Florida Gulf Coast,2,4,Stetson,-2
2021-04-25,@Florida Gulf Coast,5,7,Stetson,-2
2021-04-27,"@Miami, Florida",0,6,"Miami, Florida",-6
2021-04-30,@Florida Gulf Coast,10,1,North Florida,9
2021-05-01,@Florida Gulf Coast,11,1,North Florida,10
2021-05-02,@Florida Gulf Coast,3,7,North Florida,-4
2021-05-07,@Jacksonville,2,5,Jacksonville,-3
2021-05-08,@Jacksonville,7,5,Jacksonville,2
2021-05-09,@Jacksonville,14,11,Jacksonville,3
2021-05-12,@Florida State,8,7,Florida State,1
2021-05-12,@Florida State,1,2,Florida State,-1
2021-05-21,@Florida Gulf Coast,1,4,Jacksonville,-3
2021-05-22,@Florida Gulf Coast,7,3,Jacksonville,4
2021-05-23,@Florida Gulf Coast,1,17,Jacksonville,-16
2021-02-19,@Florida International,9,4,Illinois-Chicago,5
2021-02-20,@Florida International,4,3,Illinois-Chicago,1
2021-02-20,@Florida International,6,10,Illinois-Chicago,-4
2021-02-26,@Florida International,3,1,"Miami, Ohio",2
2021-02-27,@Florida International,8,4,"Miami, Ohio",4
2021-02-27,@Florida International,4,21,"Miami, Ohio",-17
2021-02-28,@Florida International,6,15,"Miami, Ohio",-9
2021-03-05,@Florida International,2,13,Indiana State,-11
2021-03-07,@Florida International,2,7,Indiana State,-5
2021-03-07,@Florida International,4,9,Indiana State,-5
2021-03-12,@Coastal Carolina,8,6,Coastal Carolina,2
2021-03-13,@Coastal Carolina,0,7,Coastal Carolina,-7
2021-03-13,@Coastal Carolina,7,4,Coastal Carolina,3
2021-03-14,@Coastal Carolina,1,6,Coastal Carolina,-5
2021-03-19,@Wichita State,11,2,Wichita State,9
2021-03-21,@Florida International,9,2,Wichita State,7
2021-03-23,@Florida International,3,6,Stetson,-3
2021-03-26,@Old Dominion,15,12,Old Dominion,3
2021-03-27,@Old Dominion,2,3,Old Dominion,-1
2021-03-27,@Old Dominion,0,14,Old Dominion,-14
2021-03-28,@Old Dominion,9,16,Old Dominion,-7
2021-03-31,@Florida International,1,21,"Miami, Florida",-20
2021-04-01,@Florida International,2,9,Western Kentucky,-7
2021-04-02,@Florida International,2,1,Western Kentucky,1
2021-04-02,@Florida International,3,2,Western Kentucky,1
2021-04-03,@Florida International,10,0,Western Kentucky,10
2021-04-07,"@Miami, Florida",3,8,"Miami, Florida",-5
2021-04-09,@Florida International,8,11,North Carolina-Charlotte,-3
2021-04-10,@Florida International,1,3,North Carolina-Charlotte,-2
2021-04-10,@Florida International,4,5,North Carolina-Charlotte,-1
2021-04-11,@Florida International,5,9,North Carolina-Charlotte,-4
2021-04-16,@Marshall,8,2,Marshall,6
2021-04-17,@Marshall,5,0,Marshall,5
2021-04-17,@Marshall,1,6,Marshall,-5
2021-04-18,@Marshall,8,10,Marshall,-2
2021-04-21,@Florida International,7,6,Stetson,1
2021-04-23,@Florida International,6,11,Florida Atlantic,-5
2021-04-24,@Florida International,6,5,Florida Atlantic,1
2021-04-24,@Florida International,7,16,Florida Atlantic,-9
2021-04-25,@Florida International,7,8,Florida Atlantic,-1
2021-05-01,@Florida Atlantic,6,1,Florida Atlantic,5
2021-05-01,@Florida Atlantic,2,12,Florida Atlantic,-10
2021-05-02,@Florida Atlantic,1,3,Florida Atlantic,-2
2021-05-02,@Florida Atlantic,8,9,Florida Atlantic,-1
2021-05-08,@Florida International,7,12,Louisiana Tech,-5
2021-05-08,@Florida International,10,5,Louisiana Tech,5
2021-05-14,@Middle Tennessee State,0,3,Middle Tennessee State,-3
2021-05-15,@Middle Tennessee State,0,5,Middle Tennessee State,-5
2021-05-15,@Middle Tennessee State,2,1,Middle Tennessee State,1
2021-05-16,@Middle Tennessee State,11,9,Middle Tennessee State,2
2021-05-18,@Vanderbilt,4,20,Vanderbilt,-16
2021-02-20,@Florida State,4,7,North Florida,-3
2021-02-21,@Florida State,14,7,North Florida,7
2021-02-21,@Florida State,8,4,North Florida,4
2021-02-26,@Florida State,0,1,Pittsburgh,-1
2021-02-27,@Florida State,2,7,Pittsburgh,-5
2021-02-28,@Florida State,7,9,Pittsburgh,-2
2021-03-05,@Florida State,2,0,Virginia,2
2021-03-06,@Florida State,9,4,Virginia,5
2021-03-07,@Florida State,1,2,Virginia,-1
2021-03-12,@Virginia Tech,6,4,Virginia Tech,2
2021-03-13,@Virginia Tech,0,5,Virginia Tech,-5
2021-03-14,@Virginia Tech,14,7,Virginia Tech,7
2021-03-16,@Florida State,10,2,Florida,8
2021-03-19,"@Miami, Florida",13,1,"Miami, Florida",12
2021-03-20,"@Miami, Florida",9,1,"Miami, Florida",8
2021-03-21,"@Miami, Florida",12,0,"Miami, Florida",12
2021-03-24,@Florida State,6,5,Central Florida,1
2021-03-26,@Florida State,2,1,Wake Forest,1
2021-03-27,@Florida State,7,8,Wake Forest,-1
2021-03-28,@Florida State,10,12,Wake Forest,-2
2021-03-31,@Florida State,8,1,Mercer,7
2021-04-02,@Florida State,3,4,North Carolina,-1
2021-04-03,@Florida State,4,2,North Carolina,2
2021-04-04,@Florida State,8,0,North Carolina,8
2021-04-06,@Florida State,7,8,Jacksonville,-1
2021-04-09,@Louisville,3,4,Louisville,-1
2021-04-10,@Louisville,8,5,Louisville,3
2021-04-11,@Louisville,4,11,Louisville,-7
2021-04-13,@Florida,2,3,Florida,-1
2021-04-16,@Florida State,10,2,Boston College,8
2021-04-17,@Florida State,5,1,Boston College,4
2021-04-18,@Florida State,3,5,Boston College,-2
2021-04-23,@Georgia Tech,9,0,Georgia Tech,9
2021-04-25,@Georgia Tech,8,9,Georgia Tech,-1
2021-04-25,@Georgia Tech,13,10,Georgia Tech,3
2021-04-27,@Florida State,9,5,Stetson,4
2021-04-30,@Florida State,3,2,Troy,1
2021-05-01,@Florida State,0,3,Troy,-3
2021-05-02,@Florida State,4,2,Troy,2
2021-05-07,@Notre Dame,5,2,Notre Dame,3
2021-05-08,@Notre Dame,3,5,Notre Dame,-2
2021-05-08,@Notre Dame,7,1,Notre Dame,6
2021-05-12,@Florida State,7,8,Florida Gulf Coast,-1
2021-05-12,@Florida State,2,1,Florida Gulf Coast,1
2021-05-14,@Florida State,8,3,Clemson,5
2021-05-15,@Florida State,5,9,Clemson,-4
2021-05-16,@Florida State,9,6,Clemson,3
2021-05-20,@North Carolina State,4,6,North Carolina State,-2
2021-05-21,@North Carolina State,4,6,North Carolina State,-2
2021-05-22,@North Carolina State,15,11,North Carolina State,4
2021-05-26,@Florida State,1,12,Duke,-11
2021-05-28,"@Miami, Florida",6,3,"Miami, Florida",3
2021-06-04,@Southern Mississippi,5,2,Southern Mississippi,3
2021-06-05,@Florida State,3,4,Mississippi,-1
2021-06-06,@Florida State,4,7,Southern Mississippi,-3
2021-03-06,@Fordham,5,3,New Jersey Tech,2
2021-03-07,@Fordham,5,4,New Jersey Tech,1
2021-03-07,@Fordham,8,2,New Jersey Tech,6
2021-03-09,@Stony Brook,9,7,Stony Brook,2
2021-03-10,@Fordham,10,0,Sacred Heart,10
2021-03-12,@Fordham,9,0,Fairleigh Dickinson,9
2021-03-13,@Fordham,2,4,Fairleigh Dickinson,-2
2021-03-14,@Fordham,6,2,Fairleigh Dickinson,4
2021-03-19,@St. John's,1,4,St. John's,-3
2021-03-20,@Fordham,7,6,St. John's,1
2021-03-20,@Fordham,3,4,St. John's,-1
2021-03-21,@St. John's,7,6,St. John's,1
2021-03-24,@Sacred Heart,4,10,Sacred Heart,-6
2021-03-27,@Delaware,15,2,Delaware,13
2021-03-27,@Delaware,8,1,Delaware,7
2021-03-31,@Fordham,3,4,Seton Hall,-1
2021-04-01,@Seton Hall,4,11,Seton Hall,-7
2021-04-03,@Seton Hall,1,0,Seton Hall,1
2021-04-09,@Fordham,4,1,St. Bonaventure,3
2021-04-09,@Fordham,4,7,St. Bonaventure,-3
2021-04-10,@Fordham,3,0,St. Bonaventure,3
2021-04-10,@Fordham,7,5,St. Bonaventure,2
2021-04-13,@Fordham,3,2,Army,1
2021-04-17,@Towson,3,5,Towson,-2
2021-04-17,@Towson,2,3,Towson,-1
2021-04-20,@Army,2,8,Army,-6
2021-04-23,@St. Joseph's,3,13,St. Joseph's,-10
2021-04-24,@St. Joseph's,1,11,St. Joseph's,-10
2021-04-24,@St. Joseph's,3,1,St. Joseph's,2
2021-04-25,@St. Joseph's,3,2,St. Joseph's,1
2021-04-30,@Fordham,2,4,Massachusetts,-2
2021-05-01,@Fordham,3,8,Massachusetts,-5
2021-05-01,@Fordham,5,3,Massachusetts,2
2021-05-02,@Fordham,11,1,Massachusetts,10
2021-05-05,@Fordham,8,11,Army,-3
2021-05-14,@Fordham,2,14,LaSalle,-12
2021-05-15,@Fordham,4,8,LaSalle,-4
2021-05-15,@Fordham,4,2,LaSalle,2
2021-05-16,@Fordham,5,9,LaSalle,-4
2021-05-20,@St. Bonaventure,11,10,St. Bonaventure,1
2021-05-21,@St. Bonaventure,2,1,St. Bonaventure,1
2021-05-21,@St. Bonaventure,11,12,St. Bonaventure,-1
2021-05-22,@St. Bonaventure,14,12,St. Bonaventure,2
2021-02-26,@Fresno State,13,2,CSU Bakersfield,11
2021-02-27,@Fresno State,9,6,CSU Bakersfield,3
2021-02-28,@Fresno State,4,9,CSU Bakersfield,-5
2021-03-02,@San Francisco,6,7,San Francisco,-1
2021-03-06,@San Diego State,0,17,San Diego State,-17
2021-03-06,@San Diego State,3,2,San Diego State,1
2021-03-07,@San Diego State,7,12,San Diego State,-5
2021-03-13,@Fresno State,0,1,New Mexico,-1
2021-03-13,@Fresno State,5,2,New Mexico,3
2021-03-14,@Fresno State,6,5,New Mexico,1
2021-03-17,@Pacific,2,3,Pacific,-1
2021-03-20,@Nevada,6,7,Nevada,-1
2021-03-20,@Nevada,10,20,Nevada,-10
2021-03-21,@Nevada,8,3,Nevada,5
2021-03-24,@Fresno State,5,4,Pacific,1
2021-03-27,@Stanford,4,12,Stanford,-8
2021-03-28,@Stanford,8,11,Stanford,-3
2021-04-02,@Nevada-Las Vegas,9,10,Nevada-Las Vegas,-1
2021-04-02,@Nevada-Las Vegas,5,9,Nevada-Las Vegas,-4
2021-04-03,@Nevada-Las Vegas,6,9,Nevada-Las Vegas,-3
2021-04-07,@Fresno State,10,14,Pacific,-4
2021-04-10,@Fresno State,8,3,Air Force,5
2021-04-10,@Fresno State,7,1,Air Force,6
2021-04-11,@Fresno State,6,12,Air Force,-6
2021-04-13,@Southern California,1,2,Southern California,-1
2021-04-17,@Fresno State,11,12,San Diego State,-1
2021-04-17,@Fresno State,5,3,San Diego State,2
2021-04-18,@Fresno State,14,21,San Diego State,-7
2021-04-23,@San Jose State,4,5,San Jose State,-1
2021-04-24,@San Jose State,4,2,San Jose State,2
2021-04-24,@San Jose State,12,2,San Jose State,10
2021-04-25,@San Jose State,8,7,San Jose State,1
2021-05-01,@New Mexico,11,9,New Mexico,2
2021-05-01,@New Mexico,10,8,New Mexico,2
2021-05-02,@New Mexico,12,9,New Mexico,3
2021-05-15,@Fresno State,2,14,Nevada,-12
2021-05-15,@Fresno State,6,9,Nevada,-3
2021-05-16,@Fresno State,1,3,Nevada,-2
2021-05-18,@Fresno State,13,10,Southern California,3
2021-05-22,@Fresno State,6,4,Nevada-Las Vegas,2
2021-05-22,@Fresno State,2,13,Nevada-Las Vegas,-11
2021-05-23,@Fresno State,12,2,Nevada-Las Vegas,10
2021-05-28,@Air Force,6,13,Air Force,-7
2021-05-28,@Air Force,7,9,Air Force,-2
2021-05-29,@Air Force,9,8,Air Force,1
2021-02-19,@Gardner-Webb,5,4,Wofford,1
2021-02-20,@Gardner-Webb,10,11,Wofford,-1
2021-02-21,@Wofford,0,9,Wofford,-9
2021-02-27,@Georgia,2,3,Georgia,-1
2021-02-27,@Georgia,1,5,Georgia,-4
2021-02-28,@Georgia,3,17,Georgia,-14
2021-03-05,@Campbell,6,2,Campbell,4
2021-03-06,@Campbell,6,14,Campbell,-8
2021-03-06,@Campbell,3,7,Campbell,-4
2021-03-20,@Gardner-Webb,1,5,Charleston Southern,-4
2021-03-20,@Gardner-Webb,6,5,Charleston Southern,1
2021-03-21,@Gardner-Webb,4,7,Charleston Southern,-3
2021-03-23,@North Carolina-Asheville,6,3,North Carolina-Asheville,3
2021-03-26,@High Point,6,3,High Point,3
2021-03-28,@High Point,5,4,High Point,1
2021-03-28,@High Point,5,3,High Point,2
2021-03-30,@South Carolina,4,9,South Carolina,-5
2021-04-01,@Gardner-Webb,10,3,Longwood,7
2021-04-01,@Gardner-Webb,10,2,Longwood,8
2021-04-02,@Gardner-Webb,7,3,Longwood,4
2021-04-06,@Radford,9,7,Radford,2
2021-04-07,@Gardner-Webb,2,12,Western Carolina,-10
2021-04-09,@South Carolina-Upstate,8,5,South Carolina-Upstate,3
2021-04-11,@South Carolina-Upstate,2,13,South Carolina-Upstate,-11
2021-04-11,@South Carolina-Upstate,8,9,South Carolina-Upstate,-1
2021-04-13,@Gardner-Webb,5,4,Winthrop,1
2021-04-14,@Gardner-Webb,0,9,North Carolina-Greensboro,-9
2021-04-16,@Gardner-Webb,6,10,Campbell,-4
2021-04-17,@Gardner-Webb,1,10,Campbell,-9
2021-04-17,@Gardner-Webb,10,8,Campbell,2
2021-04-20,@Gardner-Webb,15,4,North Carolina-Asheville,11
2021-04-23,@Gardner-Webb,8,7,Winthrop,1
2021-04-23,@Gardner-Webb,13,1,Winthrop,12
2021-04-25,@Gardner-Webb,9,7,Winthrop,2
2021-04-27,@Winthrop,9,7,Winthrop,2
2021-04-30,@Charleston Southern,5,4,Charleston Southern,1
2021-05-01,@Charleston Southern,10,6,Charleston Southern,4
2021-05-01,@Charleston Southern,1,7,Charleston Southern,-6
2021-05-07,@Presbyterian,10,2,Presbyterian,8
2021-05-08,@Presbyterian,3,9,Presbyterian,-6
2021-05-08,@Presbyterian,10,6,Presbyterian,4
2021-05-11,@Gardner-Webb,6,9,Radford,-3
2021-05-14,@Gardner-Webb,7,6,North Carolina-Asheville,1
2021-05-15,@Gardner-Webb,8,7,North Carolina-Asheville,1
2021-05-15,@Gardner-Webb,11,6,North Carolina-Asheville,5
2021-05-18,@Winthrop,6,7,Winthrop,-1
2021-05-20,@Gardner-Webb,10,8,Radford,2
2021-05-21,@Gardner-Webb,7,5,Radford,2
2021-05-21,@Gardner-Webb,4,8,Radford,-4
2021-05-27,@South Carolina-Upstate,11,4,South Carolina-Upstate,7
2021-05-28,@Campbell,9,13,Campbell,-4
2021-05-28,@Gardner-Webb,6,9,Presbyterian,-3
2021-02-27,@Navy,3,7,Navy,-4
2021-02-27,@Navy,2,3,Navy,-1
2021-03-05,@George Mason,10,7,Richmond,3
2021-03-06,@George Mason,1,4,William and Mary,-3
2021-03-12,@George Mason,10,14,Maryland-Baltimore County,-4
2021-03-13,@LaSalle,10,5,LaSalle,5
2021-03-13,@LaSalle,2,4,LaSalle,-2
2021-03-14,@Maryland-Baltimore County,7,13,Maryland-Baltimore County,-6
2021-03-20,@George Mason,8,3,LaSalle,5
2021-03-20,@George Mason,1,7,LaSalle,-6
2021-03-21,@Richmond,5,12,Richmond,-7
2021-03-26,@Towson,2,3,Towson,-1
2021-03-27,@George Mason,1,5,Towson,-4
2021-03-27,@George Mason,10,9,Towson,1
2021-03-28,@Towson,5,6,Towson,-1
2021-04-02,@George Mason,9,6,St. Bonaventure,3
2021-04-03,@George Mason,3,8,St. Bonaventure,-5
2021-04-03,@George Mason,2,1,St. Bonaventure,1
2021-04-04,@George Mason,6,5,St. Bonaventure,1
2021-04-09,@George Mason,4,6,St. Louis,-2
2021-04-09,@George Mason,7,3,St. Louis,4
2021-04-10,@George Mason,0,7,St. Louis,-7
2021-04-11,@George Mason,2,4,St. Louis,-2
2021-04-16,@Dayton,7,6,Dayton,1
2021-04-17,@Dayton,1,11,Dayton,-10
2021-04-17,@Dayton,10,12,Dayton,-2
2021-04-18,@Dayton,3,14,Dayton,-11
2021-04-30,@Virginia Commonwealth,2,9,Virginia Commonwealth,-7
2021-05-01,@Virginia Commonwealth,1,3,Virginia Commonwealth,-2
2021-05-01,@Virginia Commonwealth,1,8,Virginia Commonwealth,-7
2021-05-02,@Virginia Commonwealth,2,11,Virginia Commonwealth,-9
2021-05-08,@George Mason,8,11,George Washington,-3
2021-05-08,@George Mason,11,1,George Washington,10
2021-05-09,@George Mason,0,5,George Washington,-5
2021-05-09,@George Mason,7,13,George Washington,-6
2021-05-14,@Davidson,5,3,Davidson,2
2021-05-15,@Davidson,7,8,Davidson,-1
2021-05-15,@Davidson,4,5,Davidson,-1
2021-05-16,@Davidson,10,4,Davidson,6
2021-05-20,@George Mason,6,5,Richmond,1
2021-05-21,@George Mason,12,5,Richmond,7
2021-05-21,@George Mason,0,2,Richmond,-2
2021-05-22,@George Mason,1,11,Richmond,-10
2021-03-02,@Virginia,1,11,Virginia,-10
2021-03-06,@George Washington,4,1,Lehigh,3
2021-03-06,@George Washington,9,2,Lehigh,7
2021-03-07,@Lehigh,13,9,Lehigh,4
2021-03-07,@Lehigh,4,3,Lehigh,1
2021-03-10,@George Washington,9,4,Coppin State,5
2021-03-13,@George Washington,1,4,St. Joseph's,-3
2021-03-14,@George Washington,14,16,St. Joseph's,-2
2021-03-14,@George Washington,12,13,St. Joseph's,-1
2021-03-17,@George Washington,1,8,VMI,-7
2021-03-19,@George Washington,13,8,Seton Hall,5
2021-03-20,@George Washington,0,8,Seton Hall,-8
2021-03-21,@George Washington,4,8,Seton Hall,-4
2021-03-27,@George Washington,16,1,Delaware State,15
2021-03-27,@George Washington,8,1,Delaware State,7
2021-03-28,@George Washington,8,2,Delaware State,6
2021-03-30,@George Washington,2,7,Virginia,-5
2021-04-09,@George Washington,4,6,Virginia Commonwealth,-2
2021-04-10,@George Washington,3,2,Virginia Commonwealth,1
2021-04-10,@George Washington,5,4,Virginia Commonwealth,1
2021-04-11,@George Washington,5,4,Virginia Commonwealth,1
2021-04-21,@George Washington,8,4,Towson,4
2021-04-23,@Davidson,10,2,Davidson,8
2021-04-23,@Davidson,4,2,Davidson,2
2021-04-25,@Davidson,8,1,Davidson,7
2021-04-25,@Davidson,4,5,Davidson,-1
2021-04-28,@George Washington,5,4,Georgetown,1
2021-04-30,@George Washington,10,7,St. Louis,3
2021-05-01,@George Washington,14,7,St. Louis,7
2021-05-01,@George Washington,2,7,St. Louis,-5
2021-05-02,@George Washington,7,9,St. Louis,-2
2021-05-08,@George Mason,1,11,George Mason,-10
2021-05-08,@George Mason,11,8,George Mason,3
2021-05-09,@George Mason,5,0,George Mason,5
2021-05-09,@George Mason,13,7,George Mason,6
2021-05-14,@George Washington,6,5,Richmond,1
2021-05-15,@George Washington,7,5,Richmond,2
2021-05-15,@George Washington,0,5,Richmond,-5
2021-05-16,@George Washington,3,1,Richmond,2
2021-05-18,@George Washington,15,4,Georgetown,11
2021-05-20,@Dayton,4,6,Dayton,-2
2021-05-21,@Dayton,4,7,Dayton,-3
2021-05-21,@Dayton,4,11,Dayton,-7
2021-05-22,@Dayton,9,14,Dayton,-5
2021-04-07,@Georgetown,4,13,Virginia Commonwealth,-9
2021-04-09,@Connecticut,0,10,Connecticut,-10
2021-04-10,@Connecticut,0,6,Connecticut,-6
2021-04-13,@Georgetown,0,4,Towson,-4
2021-04-16,@Georgetown,5,1,St. John's,4
2021-04-17,@Georgetown,11,7,St. John's,4
2021-04-17,@Georgetown,4,9,St. John's,-5
2021-04-18,@Georgetown,6,4,St. John's,2
2021-04-23,@Georgetown,0,5,Creighton,-5
2021-04-23,@Georgetown,0,6,Creighton,-6
2021-04-24,@Georgetown,2,4,Creighton,-2
2021-04-25,@Georgetown,3,2,Creighton,1
2021-04-28,@George Washington,4,5,George Washington,-1
2021-04-30,@Seton Hall,7,8,Seton Hall,-1
2021-05-01,@Seton Hall,0,2,Seton Hall,-2
2021-05-01,@Seton Hall,4,8,Seton Hall,-4
2021-05-02,@Seton Hall,0,2,Seton Hall,-2
2021-05-05,@Virginia Tech,2,6,Virginia Tech,-4
2021-05-07,@Villanova,4,6,Villanova,-2
2021-05-08,@Villanova,0,4,Villanova,-4
2021-05-09,@Villanova,1,2,Villanova,-1
2021-05-14,@Xavier,0,9,Xavier,-9
2021-05-14,@Xavier,0,2,Xavier,-2
2021-05-15,@Xavier,5,1,Xavier,4
2021-05-16,@Xavier,0,10,Xavier,-10
2021-05-16,@Xavier,1,2,Xavier,-1
2021-05-18,@George Washington,4,15,George Washington,-11
2021-05-20,@Georgetown,0,2,Butler,-2
2021-05-20,@Georgetown,5,4,Butler,1
2021-05-21,@Georgetown,7,13,Butler,-6
2021-05-22,@Georgetown,3,11,Butler,-8
2021-02-19,@Georgia,2,3,Evansville,-1
2021-02-20,@Georgia,6,5,Evansville,1
2021-02-20,@Georgia,7,3,Evansville,4
2021-02-21,@Georgia,4,1,Evansville,3
2021-02-24,@Georgia State,6,2,Georgia State,4
2021-02-27,@Georgia,3,2,Gardner-Webb,1
2021-02-27,@Georgia,5,1,Gardner-Webb,4
2021-02-28,@Georgia,17,3,Gardner-Webb,14
2021-03-03,@Kennesaw State,4,6,Kennesaw State,-2
2021-03-05,@Georgia,4,7,North Florida,-3
2021-03-06,@Georgia,6,0,North Florida,6
2021-03-07,@Georgia,7,4,North Florida,3
2021-03-09,@Georgia Southern,5,2,Georgia Southern,3
2021-03-12,@Georgia,10,0,Lipscomb,10
2021-03-13,@Georgia,7,0,Lipscomb,7
2021-03-14,@Georgia,3,2,Lipscomb,1
2021-03-19,@Georgia,6,11,Tennessee,-5
2021-03-20,@Georgia,5,4,Tennessee,1
2021-03-21,@Georgia,1,4,Tennessee,-3
2021-03-23,@Georgia,3,2,Kennesaw State,1
2021-03-26,@Texas A&M,3,6,Texas A&M,-3
2021-03-27,@Texas A&M,6,7,Texas A&M,-1
2021-03-28,@Texas A&M,6,4,Texas A&M,2
2021-03-30,@Clemson,2,0,Clemson,2
2021-04-02,@Georgia,5,3,South Carolina,2
2021-04-03,@Georgia,7,13,South Carolina,-6
2021-04-04,@Georgia,1,5,South Carolina,-4
2021-04-06,@Georgia,1,2,Georgia Southern,-1
2021-04-08,@Vanderbilt,14,2,Vanderbilt,12
2021-04-09,@Vanderbilt,2,5,Vanderbilt,-3
2021-04-10,@Vanderbilt,9,1,Vanderbilt,8
2021-04-13,@Georgia,10,7,Georgia State,3
2021-04-16,@Georgia,1,6,Kentucky,-5
2021-04-17,@Georgia,8,7,Kentucky,1
2021-04-18,@Georgia,17,6,Kentucky,11
2021-04-20,@Georgia,8,7,Clemson,1
2021-04-23,@Missouri,4,6,Missouri,-2
2021-04-24,@Missouri,7,5,Missouri,2
2021-04-25,@Missouri,9,4,Missouri,5
2021-04-27,@Georgia,5,7,Georgia Tech,-2
2021-04-29,@Georgia,4,0,Auburn,4
2021-04-30,@Georgia,6,10,Auburn,-4
2021-05-01,@Georgia,7,9,Auburn,-2
2021-05-07,@Arkansas,0,3,Arkansas,-3
2021-05-08,@Arkansas,7,3,Arkansas,4
2021-05-09,@Arkansas,3,5,Arkansas,-2
2021-05-14,@Florida,3,4,Florida,-1
2021-05-15,@Florida,2,9,Florida,-7
2021-05-16,@Florida,6,1,Florida,5
2021-05-18,@Georgia Tech,6,7,Georgia Tech,-1
2021-05-20,@Georgia,0,2,Mississippi,-2
2021-05-21,@Georgia,5,8,Mississippi,-3
2021-05-22,@Georgia,13,2,Mississippi,11
2021-05-25,@Georgia,4,1,Louisiana State,3
2021-05-26,@Arkansas,2,11,Arkansas,-9
2021-05-27,@Mississippi,0,4,Mississippi,-4
2021-02-19,@Georgia Southern,3,5,Tennessee,-2
2021-02-20,@Georgia Southern,3,5,Tennessee,-2
2021-02-21,@Georgia Southern,3,7,Tennessee,-4
2021-02-24,@College of Charleston,18,7,College of Charleston,11
2021-02-26,@Georgia Southern,4,6,East Carolina,-2
2021-02-27,@Georgia Southern,10,7,East Carolina,3
2021-02-28,@Georgia Southern,2,9,East Carolina,-7
2021-03-03,@North Florida,3,1,North Florida,2
2021-03-05,@Georgia Southern,5,1,Towson,4
2021-03-06,@Georgia Southern,7,5,Towson,2
2021-03-07,@Georgia Southern,6,5,Towson,1
2021-03-09,@Georgia Southern,2,5,Georgia,-3
2021-03-12,@Georgia Southern,11,7,Alabama-Birmingham,4
2021-03-13,@Georgia Southern,15,4,Alabama-Birmingham,11
2021-03-14,@Georgia Southern,9,5,Alabama-Birmingham,4
2021-03-19,@Troy,8,1,Troy,7
2021-03-20,@Troy,8,11,Troy,-3
2021-03-21,@Troy,4,8,Troy,-4
2021-03-23,@Clemson,4,6,Clemson,-2
2021-03-26,@Georgia Southern,3,1,Appalachian State,2
2021-03-27,@Georgia Southern,10,2,Appalachian State,8
2021-03-28,@Georgia Southern,1,3,Appalachian State,-2
2021-03-30,@Georgia Southern,3,6,College of Charleston,-3
2021-04-01,@Georgia State,23,1,Georgia State,22
2021-04-02,@Georgia State,6,7,Georgia State,-1
2021-04-03,@Georgia State,2,3,Georgia State,-1
2021-04-06,@Georgia,2,1,Georgia,1
2021-04-09,@Georgia Southern,4,3,Louisiana-Monroe,1
2021-04-10,@Georgia Southern,4,1,Louisiana-Monroe,3
2021-04-11,@Georgia Southern,7,1,Louisiana-Monroe,6
2021-04-13,@Georgia Southern,8,6,North Florida,2
2021-04-14,@Georgia Southern,3,2,Mercer,1
2021-04-16,@Coastal Carolina,8,2,Coastal Carolina,6
2021-04-17,@Coastal Carolina,8,3,Coastal Carolina,5
2021-04-18,@Coastal Carolina,6,8,Coastal Carolina,-2
2021-04-21,@Kennesaw State,11,5,Kennesaw State,6
2021-04-24,@Oklahoma,3,2,Oklahoma,1
2021-04-24,@Oklahoma,4,1,Oklahoma,3
2021-04-25,@Oklahoma,4,14,Oklahoma,-10
2021-04-27,@Georgia Southern,4,3,Jacksonville,1
2021-04-30,@Georgia Southern,5,12,South Alabama,-7
2021-05-01,@Georgia Southern,11,2,South Alabama,9
2021-05-02,@Georgia Southern,7,6,South Alabama,1
2021-05-07,@Arkansas State,1,6,Arkansas State,-5
2021-05-08,@Arkansas State,0,4,Arkansas State,-4
2021-05-08,@Arkansas State,3,2,Arkansas State,1
2021-05-13,@Elon,5,8,Elon,-3
2021-05-14,@Elon,4,6,Elon,-2
2021-05-15,@Elon,7,5,Elon,2
2021-05-18,@Mercer,1,5,Mercer,-4
2021-05-20,@Georgia Southern,3,5,Texas-Arlington,-2
2021-05-21,@Georgia Southern,3,2,Texas-Arlington,1
2021-05-22,@Georgia Southern,6,3,Texas-Arlington,3
2021-05-26,@Georgia Southern,10,1,Georgia State,9
2021-05-28,@Georgia Southern,9,5,Louisiana-Monroe,4
2021-05-29,@Louisiana-Lafayette,3,2,Louisiana-Lafayette,1
2021-05-30,@South Alabama,4,10,South Alabama,-6
2021-02-19,@Georgia State,3,5,West Virginia,-2
2021-02-20,@Georgia State,20,4,West Virginia,16
2021-02-20,@Georgia State,7,6,West Virginia,1
2021-02-21,@Georgia State,2,3,West Virginia,-1
2021-02-24,@Georgia State,2,6,Georgia,-4
2021-02-26,@Vanderbilt,4,2,Vanderbilt,2
2021-02-27,@Vanderbilt,4,5,Vanderbilt,-1
2021-02-28,@Vanderbilt,6,17,Vanderbilt,-11
2021-02-28,@Vanderbilt,2,12,Vanderbilt,-10
2021-03-03,@Georgia Tech,10,1,Georgia Tech,9
2021-03-05,@Tennessee,1,6,Tennessee,-5
2021-03-06,@Tennessee,1,5,Tennessee,-4
2021-03-07,@Tennessee,0,7,Tennessee,-7
2021-03-09,@Florida,1,5,Florida,-4
2021-03-12,@Kentucky,1,16,Kentucky,-15
2021-03-13,@Kentucky,1,6,Kentucky,-5
2021-03-14,@Kentucky,2,4,Kentucky,-2
2021-03-16,@Clemson,2,7,Clemson,-5
2021-03-19,@Louisiana-Monroe,4,3,Louisiana-Monroe,1
2021-03-20,@Louisiana-Monroe,1,3,Louisiana-Monroe,-2
2021-03-21,@Louisiana-Monroe,7,9,Louisiana-Monroe,-2
2021-03-23,@Georgia State,3,5,Mercer,-2
2021-03-26,@Georgia State,1,5,Kennesaw State,-4
2021-03-27,@Georgia State,4,7,Kennesaw State,-3
2021-03-28,@Kennesaw State,4,16,Kennesaw State,-12
2021-03-29,@Kennesaw State,1,5,Kennesaw State,-4
2021-04-01,@Georgia State,1,23,Georgia Southern,-22
2021-04-02,@Georgia State,7,6,Georgia Southern,1
2021-04-03,@Georgia State,3,2,Georgia Southern,1
2021-04-06,@Mercer,1,5,Mercer,-4
2021-04-09,@Appalachian State,2,4,Appalachian State,-2
2021-04-11,@Appalachian State,15,13,Appalachian State,2
2021-04-11,@Appalachian State,7,9,Appalachian State,-2
2021-04-13,@Georgia,7,10,Georgia,-3
2021-04-16,@Georgia State,0,4,Troy,-4
2021-04-17,@Georgia State,7,5,Troy,2
2021-04-18,@Georgia State,17,15,Troy,2
2021-04-20,@Georgia State,2,7,Georgia Tech,-5
2021-04-21,@Mercer,4,17,Mercer,-13
2021-04-23,@South Alabama,2,4,South Alabama,-2
2021-04-25,@South Alabama,1,5,South Alabama,-4
2021-04-25,@South Alabama,2,4,South Alabama,-2
2021-04-27,@Georgia State,4,3,Wofford,1
2021-04-30,@Georgia State,2,1,Coastal Carolina,1
2021-05-01,@Georgia State,4,8,Coastal Carolina,-4
2021-05-02,@Georgia State,10,12,Coastal Carolina,-2
2021-05-11,@Georgia State,4,7,Mercer,-3
2021-05-14,@Texas State,9,4,Texas State,5
2021-05-14,@Texas State,7,4,Texas State,3
2021-05-15,@Texas State,7,5,Texas State,2
2021-05-20,@Georgia State,3,7,Arkansas-Little Rock,-4
2021-05-21,@Georgia State,5,0,Arkansas-Little Rock,5
2021-05-22,@Georgia State,11,10,Arkansas-Little Rock,1
2021-05-25,@Louisiana-Monroe,9,6,Louisiana-Monroe,3
2021-05-26,@Georgia Southern,1,10,Georgia Southern,-9
2021-02-19,@Georgia Tech,12,6,Eastern Kentucky,6
2021-02-20,@Georgia Tech,6,9,Eastern Kentucky,-3
2021-02-21,@Georgia Tech,7,1,Eastern Kentucky,6
2021-02-24,@Georgia Tech,7,3,Mercer,4
2021-02-27,@North Carolina State,8,3,North Carolina State,5
2021-02-27,@North Carolina State,9,2,North Carolina State,7
2021-02-28,@North Carolina State,8,4,North Carolina State,4
2021-03-03,@Georgia Tech,1,10,Georgia State,-9
2021-03-05,@Georgia Tech,6,13,Louisville,-7
2021-03-06,@Georgia Tech,19,6,Louisville,13
2021-03-07,@Georgia Tech,13,9,Louisville,4
2021-03-12,@Georgia Tech,9,11,Pittsburgh,-2
2021-03-13,@Georgia Tech,5,3,Pittsburgh,2
2021-03-14,@Georgia Tech,12,18,Pittsburgh,-6
2021-03-19,@Wake Forest,2,6,Wake Forest,-4
2021-03-20,@Wake Forest,3,1,Wake Forest,2
2021-03-21,@Wake Forest,8,1,Wake Forest,7
2021-03-26,@Duke,5,2,Duke,3
2021-03-27,@Duke,3,0,Duke,3
2021-03-28,@Duke,7,9,Duke,-2
2021-04-01,@Georgia Tech,6,5,Virginia,1
2021-04-02,@Georgia Tech,2,8,Virginia,-6
2021-04-03,@Georgia Tech,4,11,Virginia,-7
2021-04-06,@Georgia Tech,3,9,South Carolina-Upstate,-6
2021-04-09,@Notre Dame,9,10,Notre Dame,-1
2021-04-10,@Notre Dame,0,7,Notre Dame,-7
2021-04-11,@Notre Dame,4,2,Notre Dame,2
2021-04-13,@Georgia Tech,3,7,Auburn,-4
2021-04-16,@Virginia Tech,15,11,Virginia Tech,4
2021-04-17,@Virginia Tech,0,7,Virginia Tech,-7
2021-04-18,@Virginia Tech,11,4,Virginia Tech,7
2021-04-20,@Georgia State,7,2,Georgia State,5
2021-04-23,@Georgia Tech,0,9,Florida State,-9
2021-04-25,@Georgia Tech,9,8,Florida State,1
2021-04-25,@Georgia Tech,10,13,Florida State,-3
2021-04-27,@Georgia,7,5,Georgia,2
2021-04-30,@Georgia Tech,1,5,Kennesaw State,-4
2021-05-01,@Georgia Tech,13,5,Kennesaw State,8
2021-05-02,@Kennesaw State,5,10,Kennesaw State,-5
2021-05-07,@Georgia Tech,6,1,Clemson,5
2021-05-08,@Georgia Tech,6,5,Clemson,1
2021-05-09,@Georgia Tech,9,8,Clemson,1
2021-05-14,"@Miami, Florida",14,3,"Miami, Florida",11
2021-05-15,"@Miami, Florida",3,10,"Miami, Florida",-7
2021-05-16,"@Miami, Florida",4,5,"Miami, Florida",-1
2021-05-18,@Georgia Tech,7,6,Georgia,1
2021-05-20,@Georgia Tech,2,3,North Carolina,-1
2021-05-21,@Georgia Tech,10,9,North Carolina,1
2021-05-22,@Georgia Tech,10,6,North Carolina,4
2021-05-26,@Clemson,5,11,Clemson,-6
2021-05-27,@Georgia Tech,9,8,Louisville,1
2021-05-29,@Georgia Tech,1,8,North Carolina State,-7
2021-06-04,@Georgia Tech,7,6,Indiana State,1
2021-06-05,@Vanderbilt,3,4,Vanderbilt,-1
2021-06-06,@Indiana State,9,0,Indiana State,9
2021-06-06,@Georgia Tech,11,14,Vanderbilt,-3
2021-02-19,@Gonzaga,4,3,New Mexico,1
2021-02-20,@Kansas State,17,5,Kansas State,12
2021-02-21,@Oregon State,4,20,Oregon State,-16
2021-02-22,@Gonzaga,1,6,Kansas State,-5
2021-02-25,@Dallas Baptist,10,7,Dallas Baptist,3
2021-02-26,@Dallas Baptist,2,13,Dallas Baptist,-11
2021-02-27,@Dallas Baptist,19,7,Dallas Baptist,12
2021-02-28,@Dallas Baptist,7,8,Dallas Baptist,-1
2021-03-05,@Gonzaga,0,2,Portland,-2
2021-03-06,@Gonzaga,7,0,Portland,7
2021-03-07,@Gonzaga,8,1,Portland,7
2021-03-09,@Texas Tech,4,5,Texas Tech,-1
2021-03-10,@Texas Tech,4,5,Texas Tech,-1
2021-03-12,@Texas Christian,13,8,Texas Christian,5
2021-03-13,@Texas Christian,1,7,Texas Christian,-6
2021-03-14,@Texas Christian,10,7,Texas Christian,3
2021-03-19,@Santa Clara,2,0,Santa Clara,2
2021-03-20,@Santa Clara,10,4,Santa Clara,6
2021-03-21,@Santa Clara,5,2,Santa Clara,3
2021-03-23,@Gonzaga,7,2,Washington,5
2021-03-26,@Loyola Marymount,1,7,Loyola Marymount,-6
2021-03-27,@Loyola Marymount,4,8,Loyola Marymount,-4
2021-03-28,@Loyola Marymount,14,2,Loyola Marymount,12
2021-04-01,@Gonzaga,9,0,Pacific,9
2021-04-02,@Gonzaga,6,0,Pacific,6
2021-04-03,@Gonzaga,2,1,Pacific,1
2021-04-05,@Oregon State,3,11,Oregon State,-8
2021-04-06,@Oregon State,5,2,Oregon State,3
2021-04-09,@Gonzaga,6,10,St. Mary's,-4
2021-04-10,@Gonzaga,21,3,St. Mary's,18
2021-04-11,@Gonzaga,2,1,St. Mary's,1
2021-04-13,@Washington State,9,0,Washington State,9
2021-04-16,@Pepperdine,10,0,Pepperdine,10
2021-04-17,@Pepperdine,3,4,Pepperdine,-1
2021-04-18,@Pepperdine,11,6,Pepperdine,5
2021-04-20,@Washington,3,0,Washington,3
2021-04-22,@Gonzaga,12,1,Brigham Young,11
2021-04-23,@Gonzaga,2,1,Brigham Young,1
2021-04-24,@Gonzaga,7,3,Brigham Young,4
2021-04-27,@Gonzaga,7,5,Washington State,2
2021-05-14,@Portland,12,4,Portland,8
2021-05-15,@Portland,6,3,Portland,3
2021-05-16,@Portland,5,3,Portland,2
2021-05-18,@Oregon,3,10,Oregon,-7
2021-05-21,@Gonzaga,3,2,San Francisco,1
2021-05-22,@Gonzaga,6,5,San Francisco,1
2021-05-23,@Gonzaga,1,11,San Francisco,-10
2021-05-27,@Gonzaga,10,0,San Diego,10
2021-05-28,@Gonzaga,0,9,San Diego,-9
2021-05-29,@Gonzaga,2,10,San Diego,-8
2021-06-04,@Gonzaga,3,0,Louisiana State,3
2021-06-05,@Gonzaga,3,7,Oregon,-4
2021-06-06,@Louisiana State,4,9,Louisiana State,-5
2021-02-26,@Memphis,9,11,Memphis,-2
2021-02-27,@Memphis,3,11,Memphis,-8
2021-02-28,@Memphis,3,17,Memphis,-14
2021-03-03,@Louisiana-Monroe,1,9,Louisiana-Monroe,-8
2021-03-05,@Southern,8,9,Southern,-1
2021-03-06,@Southern,9,10,Southern,-1
2021-03-07,@Southern,3,5,Southern,-2
2021-03-09,@Mississippi State,0,10,Mississippi State,-10
2021-03-12,@Florida A&M,4,7,Florida A&M,-3
2021-03-13,@Grambling State,1,3,Florida A&M,-2
2021-03-14,@Florida A&M,8,10,Florida A&M,-2
2021-03-17,@Grambling State,8,15,Jackson State,-7
2021-03-19,@Grambling State,5,4,Texas Southern,1
2021-03-20,@Grambling State,4,3,Texas Southern,1
2021-03-21,@Grambling State,14,13,Texas Southern,1
2021-03-24,@Jackson State,9,7,Jackson State,2
2021-03-27,@Grambling State,4,18,Tennessee-Martin,-14
2021-03-28,@Grambling State,5,2,Tennessee-Martin,3
2021-03-28,@Grambling State,5,6,Tennessee-Martin,-1
2021-03-30,@Grambling State,15,3,Louisiana-Monroe,12
2021-04-02,@Arkansas-Pine Bluff,11,1,Arkansas-Pine Bluff,10
2021-04-03,@Arkansas-Pine Bluff,11,8,Arkansas-Pine Bluff,3
2021-04-04,@Arkansas-Pine Bluff,7,5,Arkansas-Pine Bluff,2
2021-04-06,@Stephen F. Austin State,8,10,Stephen F. Austin State,-2
2021-04-10,@Grambling State,12,9,Southern,3
2021-04-10,@Grambling State,14,6,Southern,8
2021-04-11,@Grambling State,3,10,Southern,-7
2021-04-16,@Alabama State,6,16,Alabama State,-10
2021-04-17,@Alabama State,2,12,Alabama State,-10
2021-04-18,@Alabama State,6,7,Alabama State,-1
2021-04-24,@Texas Southern,10,1,Texas Southern,9
2021-04-25,@Texas Southern,16,8,Texas Southern,8
2021-04-26,@Texas Southern,10,7,Texas Southern,3
2021-04-27,@Louisiana State,0,7,Louisiana State,-7
2021-04-30,@Grambling State,5,2,Prairie View A&M,3
2021-05-01,@Grambling State,1,12,Prairie View A&M,-11
2021-05-01,@Grambling State,4,15,Prairie View A&M,-11
2021-05-07,@Grambling State,6,14,Arkansas-Pine Bluff,-8
2021-05-08,@Grambling State,9,18,Arkansas-Pine Bluff,-9
2021-05-08,@Grambling State,8,9,Arkansas-Pine Bluff,-1
2021-05-19,@Grambling State,8,1,Alabama A&M,7
2021-05-20,@Jackson State,13,14,Jackson State,-1
2021-05-21,@Grambling State,5,2,Texas Southern,3
2021-05-21,@Jackson State,5,9,Jackson State,-4
2021-02-19,@Grand Canyon,11,3,Missouri,8
2021-02-20,@Grand Canyon,8,4,Missouri,4
2021-02-20,@Grand Canyon,7,9,Missouri,-2
2021-02-21,@Grand Canyon,10,3,Missouri,7
2021-02-25,@Grand Canyon,0,4,Oregon State,-4
2021-02-26,@Grand Canyon,1,3,Oregon State,-2
2021-02-27,@Grand Canyon,2,9,Oregon State,-7
2021-02-28,@Grand Canyon,2,4,Oregon State,-2
2021-03-05,@Oklahoma State,5,11,Oklahoma State,-6
2021-03-06,@Oklahoma State,0,3,Oklahoma State,-3
2021-03-12,@Grand Canyon,2,6,Texas-Rio Grande Valley,-4
2021-03-13,@Grand Canyon,8,4,Texas-Rio Grande Valley,4
2021-03-13,@Grand Canyon,4,9,Texas-Rio Grande Valley,-5
2021-03-14,@Grand Canyon,5,2,Texas-Rio Grande Valley,3
2021-03-19,@Grand Canyon,5,3,Seattle,2
2021-03-20,@Grand Canyon,9,8,Seattle,1
2021-03-20,@Grand Canyon,9,2,Seattle,7
2021-03-21,@Grand Canyon,8,4,Seattle,4
2021-03-23,@Grand Canyon,5,14,Pepperdine,-9
2021-03-24,@Grand Canyon,3,4,Pepperdine,-1
2021-03-26,@Tulane,4,7,Tulane,-3
2021-03-27,@Tulane,8,7,Tulane,1
2021-03-28,@Tulane,6,0,Tulane,6
2021-04-01,@Utah Valley,8,2,Utah Valley,6
2021-04-02,@Utah Valley,4,1,Utah Valley,3
2021-04-02,@Utah Valley,3,4,Utah Valley,-1
2021-04-03,@Utah Valley,7,2,Utah Valley,5
2021-04-09,@Grand Canyon,2,4,Northern Colorado,-2
2021-04-10,@Grand Canyon,5,0,Northern Colorado,5
2021-04-10,@Grand Canyon,4,0,Northern Colorado,4
2021-04-11,@Grand Canyon,10,3,Northern Colorado,7
2021-04-13,@Grand Canyon,5,4,Arizona,1
2021-04-16,@New Mexico State,5,4,New Mexico State,1
2021-04-17,@New Mexico State,4,2,New Mexico State,2
2021-04-17,@New Mexico State,3,1,New Mexico State,2
2021-04-18,@New Mexico State,11,3,New Mexico State,8
2021-04-20,@Arizona State,10,13,Arizona State,-3
2021-04-21,@Grand Canyon,4,1,Arizona State,3
2021-04-30,@Sacramento State,15,5,Sacramento State,10
2021-05-01,@Sacramento State,6,1,Sacramento State,5
2021-05-01,@Sacramento State,12,0,Sacramento State,12
2021-05-02,@Sacramento State,2,3,Sacramento State,-1
2021-05-04,@Arizona,2,13,Arizona,-11
2021-05-07,@Grand Canyon,10,0,Dixie State,10
2021-05-08,@Grand Canyon,5,0,Dixie State,5
2021-05-08,@Grand Canyon,4,3,Dixie State,1
2021-05-09,@Grand Canyon,6,3,Dixie State,3
2021-05-14,@Tarleton State,16,7,Tarleton State,9
2021-05-15,@Tarleton State,7,3,Tarleton State,4
2021-05-15,@Tarleton State,12,4,Tarleton State,8
2021-05-16,@Tarleton State,9,4,Tarleton State,5
2021-05-20,@Grand Canyon,5,1,California Baptist,4
2021-05-21,@Grand Canyon,2,1,California Baptist,1
2021-05-21,@Grand Canyon,3,5,California Baptist,-2
2021-05-22,@Grand Canyon,1,6,California Baptist,-5
2021-05-27,@Grand Canyon,5,4,New Mexico State,1
2021-05-28,@Grand Canyon,11,0,Sacramento State,11
2021-05-29,@Texas-Rio Grande Valley,5,4,Texas-Rio Grande Valley,1
2021-06-04,@Arizona,6,12,Arizona,-6
2021-06-05,@Grand Canyon,3,5,Oklahoma State,-2
2021-03-20,@Hartford,5,2,Binghamton,3
2021-03-20,@Hartford,7,11,Binghamton,-4
2021-03-21,@Hartford,6,2,Binghamton,4
2021-03-21,@Hartford,2,1,Binghamton,1
2021-03-26,@Hartford,4,5,New Jersey Tech,-1
2021-03-26,@Hartford,8,4,New Jersey Tech,4
2021-03-27,@Hartford,8,6,New Jersey Tech,2
2021-03-27,@Hartford,5,0,New Jersey Tech,5
2021-04-02,@Stony Brook,2,5,Stony Brook,-3
2021-04-02,@Stony Brook,1,7,Stony Brook,-6
2021-04-03,@Stony Brook,5,6,Stony Brook,-1
2021-04-03,@Stony Brook,2,6,Stony Brook,-4
2021-04-10,@Maryland-Baltimore County,5,8,Maryland-Baltimore County,-3
2021-04-10,@Maryland-Baltimore County,10,3,Maryland-Baltimore County,7
2021-04-11,@Maryland-Baltimore County,6,14,Maryland-Baltimore County,-8
2021-04-11,@Maryland-Baltimore County,7,13,Maryland-Baltimore County,-6
2021-04-17,@Maine,0,11,Maine,-11
2021-04-17,@Maine,7,0,Maine,7
2021-04-23,@Hartford,1,10,Albany,-9
2021-04-23,@Hartford,4,3,Albany,1
2021-04-24,@Hartford,12,6,Albany,6
2021-04-24,@Hartford,8,7,Albany,1
2021-05-01,@Hartford,8,2,Massachusetts-Lowell,6
2021-05-01,@Hartford,6,7,Massachusetts-Lowell,-1
2021-05-02,@Hartford,9,8,Massachusetts-Lowell,1
2021-05-02,@Hartford,11,4,Massachusetts-Lowell,7
2021-05-08,@Albany,4,0,Albany,4
2021-05-08,@Albany,2,3,Albany,-1
2021-05-09,@Albany,7,11,Albany,-4
2021-05-09,@Albany,4,5,Albany,-1
2021-05-14,@Hartford,6,5,Maine,1
2021-05-15,@Hartford,0,15,Maine,-15
2021-05-15,@Hartford,2,6,Maine,-4
2021-05-16,@Hartford,6,16,Maine,-10
2021-05-21,@Massachusetts-Lowell,1,7,Massachusetts-Lowell,-6
2021-05-21,@Massachusetts-Lowell,4,7,Massachusetts-Lowell,-3
2021-05-22,@Massachusetts-Lowell,7,5,Massachusetts-Lowell,2
2021-05-22,@Massachusetts-Lowell,3,0,Massachusetts-Lowell,3
2021-02-26,@Arizona State,3,2,Arizona State,1
2021-02-27,@Arizona State,6,9,Arizona State,-3
2021-02-27,@Arizona State,5,6,Arizona State,-1
2021-03-04,@Hawaii,12,1,Hawaii Pacific,11
2021-03-05,@Hawaii,14,3,Hawaii Pacific,11
2021-03-06,@Hawaii,10,2,Hawaii Pacific,8
2021-03-07,@Hawaii,10,0,Hawaii Pacific,10
2021-03-13,@Hawaii,3,2,Hawaii-Hilo,1
2021-03-13,@Hawaii,6,2,Hawaii-Hilo,4
2021-03-14,@Hawaii,13,0,Hawaii-Hilo,13
2021-03-19,@Hawaii,3,2,Long Beach State,1
2021-03-20,@Hawaii,1,0,Long Beach State,1
2021-03-20,@Hawaii,6,4,Long Beach State,2
2021-03-21,@Hawaii,5,8,Long Beach State,-3
2021-03-26,@UC Irvine,0,4,UC Irvine,-4
2021-03-27,@UC Irvine,3,4,UC Irvine,-1
2021-03-27,@UC Irvine,5,12,UC Irvine,-7
2021-03-28,@UC Irvine,10,20,UC Irvine,-10
2021-04-02,@Hawaii,0,3,UC Santa Barbara,-3
2021-04-03,@Hawaii,4,5,UC Santa Barbara,-1
2021-04-03,@Hawaii,6,5,UC Santa Barbara,1
2021-04-04,@Hawaii,1,9,UC Santa Barbara,-8
2021-04-09,@UC Riverside,7,5,UC Riverside,2
2021-04-10,@UC Riverside,13,4,UC Riverside,9
2021-04-10,@UC Riverside,7,0,UC Riverside,7
2021-04-11,@UC Riverside,2,9,UC Riverside,-7
2021-04-16,@Hawaii,2,5,CSU Bakersfield,-3
2021-04-17,@Hawaii,1,4,CSU Bakersfield,-3
2021-04-17,@Hawaii,11,4,CSU Bakersfield,7
2021-04-18,@Hawaii,4,7,CSU Bakersfield,-3
2021-04-23,@Hawaii,6,2,UC Davis,4
2021-04-24,@Hawaii,8,3,UC Davis,5
2021-04-24,@Hawaii,7,2,UC Davis,5
2021-04-25,@Hawaii,9,2,UC Davis,7
2021-04-30,@Cal State Fullerton,4,5,Cal State Fullerton,-1
2021-05-01,@Cal State Fullerton,16,8,Cal State Fullerton,8
2021-05-01,@Cal State Fullerton,4,1,Cal State Fullerton,3
2021-05-02,@Cal State Fullerton,8,2,Cal State Fullerton,6
2021-05-14,@Cal State Northridge,1,9,Cal State Northridge,-8
2021-05-15,@Cal State Northridge,0,12,Cal State Northridge,-12
2021-05-15,@Cal State Northridge,3,4,Cal State Northridge,-1
2021-05-16,@Cal State Northridge,4,6,Cal State Northridge,-2
2021-05-21,@Hawaii,2,6,UC San Diego,-4
2021-05-22,@Hawaii,2,4,UC San Diego,-2
2021-05-22,@Hawaii,5,2,UC San Diego,3
2021-05-23,@Hawaii,2,3,UC San Diego,-1
2021-05-28,@Cal Poly,3,13,Cal Poly,-10
2021-05-29,@Cal Poly,4,14,Cal Poly,-10
2021-05-29,@Cal Poly,4,5,Cal Poly,-1
2021-05-30,@Cal Poly,2,6,Cal Poly,-4
2021-02-19,@High Point,0,2,Bryant,-2
2021-02-20,@High Point,6,7,Bryant,-1
2021-02-21,@High Point,3,2,Bryant,1
2021-02-27,@High Point,2,4,North Carolina-Greensboro,-2
2021-02-28,@North Carolina-Greensboro,4,3,North Carolina-Greensboro,1
2021-02-28,@North Carolina-Greensboro,5,6,North Carolina-Greensboro,-1
2021-03-06,@High Point,12,6,North Carolina-Asheville,6
2021-03-06,@High Point,8,2,North Carolina-Asheville,6
2021-03-07,@High Point,11,10,North Carolina-Asheville,1
2021-03-12,@High Point,1,3,Radford,-2
2021-03-13,@High Point,5,9,Radford,-4
2021-03-13,@High Point,2,4,Radford,-2
2021-03-16,@High Point,9,2,Longwood,7
2021-03-19,@South Carolina-Upstate,3,1,South Carolina-Upstate,2
2021-03-20,@South Carolina-Upstate,2,7,South Carolina-Upstate,-5
2021-03-20,@South Carolina-Upstate,1,8,South Carolina-Upstate,-7
2021-03-23,@High Point,9,4,Campbell,5
2021-03-26,@High Point,3,6,Gardner-Webb,-3
2021-03-28,@High Point,3,5,Gardner-Webb,-2
2021-03-28,@High Point,4,5,Gardner-Webb,-1
2021-04-01,@Charleston Southern,10,5,Charleston Southern,5
2021-04-02,@Charleston Southern,7,10,Charleston Southern,-3
2021-04-02,@Charleston Southern,4,15,Charleston Southern,-11
2021-04-06,@Elon,7,8,Elon,-1
2021-04-09,@Longwood,12,2,Longwood,10
2021-04-10,@Longwood,11,3,Longwood,8
2021-04-10,@Longwood,1,8,Longwood,-7
2021-04-20,@Campbell,8,16,Campbell,-8
2021-04-23,@Radford,7,5,Radford,2
2021-04-23,@Radford,3,11,Radford,-8
2021-04-25,@Radford,3,4,Radford,-1
2021-04-27,@High Point,3,12,North Carolina-Greensboro,-9
2021-04-30,@Winthrop,11,2,Winthrop,9
2021-05-01,@Winthrop,10,11,Winthrop,-1
2021-05-01,@Winthrop,19,15,Winthrop,4
2021-05-07,@High Point,6,10,South Carolina-Upstate,-4
2021-05-08,@High Point,5,10,South Carolina-Upstate,-5
2021-05-08,@High Point,9,12,South Carolina-Upstate,-3
2021-05-11,@Longwood,1,8,Longwood,-7
2021-05-14,@High Point,4,11,Presbyterian,-7
2021-05-15,@High Point,6,10,Presbyterian,-4
2021-05-15,@High Point,11,13,Presbyterian,-2
2021-05-20,@Campbell,3,13,Campbell,-10
2021-05-21,@Campbell,4,7,Campbell,-3
2021-05-21,@Campbell,5,8,Campbell,-3
2021-02-21,@Seton Hall,3,2,Seton Hall,1
2021-02-21,@Seton Hall,2,3,Seton Hall,-1
2021-02-26,@LaSalle,4,2,LaSalle,2
2021-02-26,@LaSalle,7,0,LaSalle,7
2021-03-01,@LaSalle,14,5,LaSalle,9
2021-03-01,@LaSalle,5,6,LaSalle,-1
2021-03-07,@Villanova,0,5,Villanova,-5
2021-03-07,@Villanova,1,3,Villanova,-2
2021-03-12,@Hofstra,8,5,Sacred Heart,3
2021-03-13,@Hofstra,3,4,Sacred Heart,-1
2021-03-13,@Hofstra,27,7,Sacred Heart,20
2021-03-14,@Hofstra,5,0,Sacred Heart,5
2021-04-02,@Rhode Island,11,12,Rhode Island,-1
2021-04-03,@Hofstra,5,4,Rhode Island,1
2021-04-03,@Hofstra,3,1,Rhode Island,2
2021-04-09,@Hofstra,2,8,Northeastern,-6
2021-04-10,@Hofstra,2,3,Northeastern,-1
2021-04-10,@Hofstra,5,13,Northeastern,-8
2021-04-16,@Delaware,9,10,Delaware,-1
2021-04-17,@Delaware,14,4,Delaware,10
2021-04-17,@Delaware,5,7,Delaware,-2
2021-04-18,@Delaware,5,11,Delaware,-6
2021-04-23,@Hofstra,3,4,Towson,-1
2021-04-23,@Hofstra,8,9,Towson,-1
2021-04-24,@Hofstra,8,7,Towson,1
2021-04-24,@Hofstra,5,2,Towson,3
2021-04-30,@Hofstra,14,11,Delaware,3
2021-05-01,@Hofstra,8,7,Delaware,1
2021-05-01,@Hofstra,9,0,Delaware,9
2021-05-02,@Hofstra,8,22,Delaware,-14
2021-05-07,@Northeastern,1,13,Northeastern,-12
2021-05-08,@Northeastern,3,5,Northeastern,-2
2021-05-08,@Northeastern,8,14,Northeastern,-6
2021-05-09,@Northeastern,0,11,Northeastern,-11
2021-05-12,@Hofstra,3,10,Northeastern,-7
2021-05-14,@Towson,2,4,Towson,-2
2021-05-15,@Towson,5,8,Towson,-3
2021-05-15,@Towson,6,4,Towson,2
2021-05-16,@Towson,8,5,Towson,3
2021-03-17,@Boston College,12,18,Boston College,-6
2021-03-20,@Lafayette,1,3,Lafayette,-2
2021-03-21,@Lafayette,0,4,Lafayette,-4
2021-03-21,@Lafayette,9,11,Lafayette,-2
2021-03-24,@Holy Cross,2,6,Massachusetts,-4
2021-03-27,@Army,3,7,Army,-4
2021-03-27,@Army,5,6,Army,-1
2021-03-31,@Massachusetts,7,6,Massachusetts,1
2021-04-03,@Holy Cross,7,0,Bucknell,7
2021-04-03,@Holy Cross,10,2,Bucknell,8
2021-04-04,@Holy Cross,3,2,Bucknell,1
2021-04-04,@Holy Cross,2,1,Bucknell,1
2021-04-07,@Holy Cross,11,12,Merrimack,-1
2021-04-17,@Lafayette,2,6,Lafayette,-4
2021-04-18,@Lafayette,5,4,Lafayette,1
2021-04-18,@Lafayette,2,5,Lafayette,-3
2021-04-24,@Navy,9,3,Navy,6
2021-04-24,@Navy,13,14,Navy,-1
2021-04-25,@Navy,8,0,Navy,8
2021-04-25,@Navy,10,13,Navy,-3
2021-04-27,@Boston College,2,13,Boston College,-11
2021-05-01,@Holy Cross,14,17,Army,-3
2021-05-01,@Holy Cross,4,3,Army,1
2021-05-02,@Holy Cross,2,6,Army,-4
2021-05-02,@Holy Cross,1,8,Army,-7
2021-05-05,@Merrimack,5,7,Merrimack,-2
2021-05-08,@Holy Cross,0,5,Lehigh,-5
2021-05-08,@Holy Cross,4,5,Lehigh,-1
2021-05-09,@Holy Cross,9,7,Lehigh,2
2021-05-09,@Holy Cross,1,4,Lehigh,-3
2021-02-20,@Houston,10,4,Texas Southern,6
2021-02-20,@Houston,6,1,Texas Southern,5
2021-02-21,@Houston,14,4,Texas Southern,10
2021-02-23,@Houston,12,8,Texas A&M-Corpus Christi,4
2021-02-26,@Texas A&M-Corpus Christi,2,3,Texas A&M-Corpus Christi,-1
2021-02-27,@Texas A&M-Corpus Christi,14,1,Texas A&M-Corpus Christi,13
2021-02-28,@Texas A&M-Corpus Christi,4,3,Texas A&M-Corpus Christi,1
2021-03-03,@Lamar,0,2,Lamar,-2
2021-03-05,@Houston,0,1,Texas,-1
2021-03-06,@Houston,3,2,Texas,1
2021-03-07,@Houston,2,8,Texas,-6
2021-03-10,@Incarnate Word,13,7,Incarnate Word,6
2021-03-12,@Texas State,12,3,Texas State,9
2021-03-13,@Texas State,9,15,Texas State,-6
2021-03-14,@Texas State,8,7,Texas State,1
2021-03-16,@Houston,4,9,Texas A&M,-5
2021-03-19,@Oklahoma,2,7,Oklahoma,-5
2021-03-20,@Oklahoma,1,19,Oklahoma,-18
2021-03-21,@Oklahoma,2,12,Oklahoma,-10
2021-03-26,@Houston,4,1,Texas-Arlington,3
2021-03-27,@Houston,7,8,Texas-Arlington,-1
2021-03-27,@Houston,7,12,Texas-Arlington,-5
2021-03-28,@Houston,5,4,Texas-Arlington,1
2021-04-01,@Houston,5,3,Wichita State,2
2021-04-02,@Houston,2,3,Wichita State,-1
2021-04-02,@Houston,1,2,Wichita State,-1
2021-04-03,@Houston,2,3,Wichita State,-1
2021-04-09,@Wichita State,1,7,Wichita State,-6
2021-04-09,@Wichita State,2,10,Wichita State,-8
2021-04-10,@Wichita State,1,10,Wichita State,-9
2021-04-11,@Wichita State,2,13,Wichita State,-11
2021-04-24,@Houston,9,2,South Florida,7
2021-04-24,@Houston,4,8,South Florida,-4
2021-04-25,@Houston,5,2,South Florida,3
2021-04-25,@Houston,0,4,South Florida,-4
2021-04-30,@Tulane,4,11,Tulane,-7
2021-04-30,@Tulane,0,3,Tulane,-3
2021-05-01,@Tulane,7,4,Tulane,3
2021-05-01,@Tulane,5,6,Tulane,-1
2021-05-07,@Houston,2,7,Cincinnati,-5
2021-05-07,@Houston,0,7,Cincinnati,-7
2021-05-08,@Houston,6,5,Cincinnati,1
2021-05-09,@Houston,3,10,Cincinnati,-7
2021-05-14,@Memphis,2,1,Memphis,1
2021-05-14,@Memphis,7,13,Memphis,-6
2021-05-15,@Memphis,7,5,Memphis,2
2021-05-16,@Memphis,4,8,Memphis,-4
2021-05-20,@Central Florida,1,2,Central Florida,-1
2021-05-20,@Central Florida,1,3,Central Florida,-2
2021-05-21,@Central Florida,0,6,Central Florida,-6
2021-05-22,@Central Florida,1,2,Central Florida,-1
2021-05-25,@Tulane,1,4,Tulane,-3
2021-05-26,@Wichita State,3,5,Wichita State,-2
2021-02-20,@Rice,8,7,Rice,1
2021-02-21,@Rice,3,9,Rice,-6
2021-02-22,@Rice,0,1,Rice,-1
2021-02-26,@Texas Tech,3,18,Texas Tech,-15
2021-02-27,@Texas Tech,1,8,Texas Tech,-7
2021-02-28,@Texas Tech,2,11,Texas Tech,-9
2021-03-02,@Texas A&M,0,4,Texas A&M,-4
2021-03-06,@Louisiana-Lafayette,2,5,Louisiana-Lafayette,-3
2021-03-06,@Louisiana-Lafayette,1,4,Louisiana-Lafayette,-3
2021-03-07,@Louisiana-Lafayette,6,4,Louisiana-Lafayette,2
2021-03-09,@Rice,1,3,Rice,-2
2021-03-12,@New Orleans,0,3,New Orleans,-3
2021-03-13,@New Orleans,10,11,New Orleans,-1
2021-03-13,@New Orleans,2,8,New Orleans,-6
2021-03-14,@New Orleans,2,9,New Orleans,-7
2021-03-19,@Houston Baptist,6,12,McNeese State,-6
2021-03-20,@Houston Baptist,1,7,McNeese State,-6
2021-03-20,@Houston Baptist,7,3,McNeese State,4
2021-03-21,@Houston Baptist,0,10,McNeese State,-10
2021-03-26,@Nicholls State,5,4,Nicholls State,1
2021-03-27,@Nicholls State,4,5,Nicholls State,-1
2021-03-27,@Nicholls State,1,2,Nicholls State,-1
2021-03-28,@Nicholls State,6,2,Nicholls State,4
2021-04-01,@Houston Baptist,3,13,Lamar,-10
2021-04-02,@Houston Baptist,3,2,Lamar,1
2021-04-02,@Houston Baptist,4,15,Lamar,-11
2021-04-03,@Houston Baptist,0,12,Lamar,-12
2021-04-09,@Oral Roberts,1,6,Oral Roberts,-5
2021-04-10,@Oral Roberts,1,3,Oral Roberts,-2
2021-04-11,@Oral Roberts,2,0,Oral Roberts,2
2021-04-16,@Houston Baptist,7,6,Northwestern State,1
2021-04-17,@Houston Baptist,6,2,Northwestern State,4
2021-04-17,@Houston Baptist,2,3,Northwestern State,-1
2021-04-18,@Houston Baptist,5,6,Northwestern State,-1
2021-04-23,@Texas A&M-Corpus Christi,6,13,Texas A&M-Corpus Christi,-7
2021-04-24,@Texas A&M-Corpus Christi,3,2,Texas A&M-Corpus Christi,1
2021-04-24,@Texas A&M-Corpus Christi,0,4,Texas A&M-Corpus Christi,-4
2021-04-25,@Texas A&M-Corpus Christi,8,9,Texas A&M-Corpus Christi,-1
2021-05-02,@Houston Baptist,2,5,Abilene Christian,-3
2021-05-02,@Houston Baptist,6,8,Abilene Christian,-2
2021-05-07,@Incarnate Word,4,9,Incarnate Word,-5
2021-05-07,@Incarnate Word,4,5,Incarnate Word,-1
2021-05-08,@Incarnate Word,4,5,Incarnate Word,-1
2021-05-09,@Incarnate Word,2,3,Incarnate Word,-1
2021-05-14,@Houston Baptist,6,8,Central Arkansas,-2
2021-05-14,@Houston Baptist,7,1,Central Arkansas,6
2021-05-15,@Houston Baptist,2,3,Central Arkansas,-1
2021-05-15,@Houston Baptist,8,6,Central Arkansas,2
2021-05-20,@Southeastern Louisiana,0,10,Southeastern Louisiana,-10
2021-05-21,@Southeastern Louisiana,3,1,Southeastern Louisiana,2
2021-05-21,@Southeastern Louisiana,4,3,Southeastern Louisiana,1
2021-05-22,@Southeastern Louisiana,2,8,Southeastern Louisiana,-6
2021-03-05,@Illinois,3,6,Ohio State,-3
2021-03-06,@Illinois,6,12,Ohio State,-6
2021-03-06,@Illinois,5,6,Ohio State,-1
2021-03-07,@Illinois,8,0,Ohio State,8
2021-03-12,@Minnesota,6,1,Minnesota,5
2021-03-13,@Minnesota,11,8,Minnesota,3
2021-03-13,@Minnesota,7,1,Minnesota,6
2021-03-14,@Minnesota,3,5,Minnesota,-2
2021-03-19,@Michigan,7,4,Michigan,3
2021-03-20,@Michigan,1,8,Michigan,-7
2021-03-20,@Michigan State,0,11,Michigan State,-11
2021-03-21,@Illinois,7,3,Michigan State,4
2021-03-26,@Illinois,12,8,Northwestern,4
2021-03-27,@Illinois,14,16,Northwestern,-2
2021-03-28,@Illinois,5,12,Northwestern,-7
2021-04-02,@Illinois,6,8,Nebraska,-2
2021-04-03,@Illinois,10,8,Nebraska,2
2021-04-04,@Illinois,7,12,Nebraska,-5
2021-04-09,@Indiana,4,6,Indiana,-2
2021-04-10,@Indiana,0,8,Indiana,-8
2021-04-16,@Illinois,13,4,Michigan State,9
2021-04-17,@Illinois,15,8,Michigan State,7
2021-04-18,@Illinois,4,6,Purdue,-2
2021-04-19,@Illinois,6,20,Purdue,-14
2021-04-23,@Purdue,6,5,Purdue,1
2021-04-24,@Purdue,12,4,Purdue,8
2021-04-25,@Purdue,1,0,Purdue,1
2021-05-01,@Illinois,8,18,Michigan,-10
2021-05-01,@Illinois,5,4,Michigan,1
2021-05-02,@Michigan,4,19,Michigan,-15
2021-05-02,@Michigan,13,7,Michigan,6
2021-05-07,@Illinois,2,0,Maryland,2
2021-05-08,@Illinois,4,12,Maryland,-8
2021-05-08,@Illinois,3,5,Maryland,-2
2021-05-14,@Iowa,4,5,Iowa,-1
2021-05-15,@Iowa,14,1,Iowa,13
2021-05-16,@Iowa,6,2,Iowa,4
2021-05-18,@Indiana,3,2,Indiana,1
2021-05-21,@Illinois,9,0,Penn State,9
2021-05-22,@Illinois,14,8,Penn State,6
2021-05-23,@Illinois,4,13,Penn State,-9
2021-05-28,@Rutgers,2,3,Rutgers,-1
2021-05-29,@Rutgers,13,1,Rutgers,12
2021-05-29,@Rutgers,3,6,Rutgers,-3
2021-02-23,@Southern Illinois-Edwardsville,6,1,Southern Illinois-Edwardsville,5
2021-02-23,@Southern Illinois-Edwardsville,9,1,Southern Illinois-Edwardsville,8
2021-02-26,@Oklahoma State,2,3,Oklahoma State,-1
2021-02-27,@Oklahoma State,2,8,Oklahoma State,-6
2021-02-28,@Oklahoma State,0,6,Oklahoma State,-6
2021-03-05,@Southeast Missouri State,3,4,Southeast Missouri State,-1
2021-03-06,@Southeast Missouri State,13,1,Southeast Missouri State,12
2021-03-06,@Southeast Missouri State,1,5,Southeast Missouri State,-4
2021-03-07,@Southeast Missouri State,1,8,Southeast Missouri State,-7
2021-03-09,@Illinois State,2,1,Western Illinois,1
2021-03-12,@Illinois State,0,7,Missouri,-7
2021-03-13,@Illinois State,2,12,Missouri,-10
2021-03-13,@Illinois State,10,1,Missouri,9
2021-03-14,@Illinois State,7,12,Missouri,-5
2021-03-19,@East Carolina,3,4,East Carolina,-1
2021-03-20,@East Carolina,5,11,East Carolina,-6
2021-03-21,@East Carolina,8,11,East Carolina,-3
2021-03-24,@Illinois State,7,9,Eastern Illinois,-2
2021-03-26,@Illinois State,6,3,Arkansas State,3
2021-03-28,@Illinois State,6,13,Arkansas State,-7
2021-03-28,@Illinois State,10,9,Arkansas State,1
2021-03-30,@Eastern Illinois,4,3,Eastern Illinois,1
2021-04-02,@Southern Illinois,11,3,Southern Illinois,8
2021-04-03,@Southern Illinois,4,8,Southern Illinois,-4
2021-04-03,@Southern Illinois,6,3,Southern Illinois,3
2021-04-04,@Southern Illinois,14,11,Southern Illinois,3
2021-04-09,@Illinois State,1,6,Indiana State,-5
2021-04-09,@Illinois State,2,4,Indiana State,-2
2021-04-10,@Illinois State,5,0,Indiana State,5
2021-04-11,@Illinois State,7,8,Indiana State,-1
2021-04-16,@Wisconsin-Milwaukee,1,2,Wisconsin-Milwaukee,-1
2021-04-17,@Wisconsin-Milwaukee,1,2,Wisconsin-Milwaukee,-1
2021-04-17,@Wisconsin-Milwaukee,4,6,Wisconsin-Milwaukee,-2
2021-04-18,@Wisconsin-Milwaukee,10,2,Wisconsin-Milwaukee,8
2021-04-23,@Illinois State,0,12,Evansville,-12
2021-04-24,@Illinois State,8,7,Evansville,1
2021-04-24,@Illinois State,6,3,Evansville,3
2021-04-25,@Illinois State,3,1,Evansville,2
2021-04-27,@Illinois State,12,0,Southern Illinois-Edwardsville,12
2021-04-30,@Valparaiso,2,3,Valparaiso,-1
2021-05-01,@Valparaiso,12,3,Valparaiso,9
2021-05-01,@Valparaiso,13,17,Valparaiso,-4
2021-05-02,@Valparaiso,6,7,Valparaiso,-1
2021-05-07,@Dallas Baptist,7,18,Dallas Baptist,-11
2021-05-08,@Dallas Baptist,3,6,Dallas Baptist,-3
2021-05-08,@Dallas Baptist,7,11,Dallas Baptist,-4
2021-05-09,@Dallas Baptist,0,3,Dallas Baptist,-3
2021-05-14,@Illinois State,4,2,Missouri State,2
2021-05-15,@Illinois State,4,3,Missouri State,1
2021-05-15,@Illinois State,3,1,Missouri State,2
2021-05-16,@Illinois State,1,2,Missouri State,-1
2021-05-20,@Bradley,6,4,Bradley,2
2021-05-21,@Bradley,3,4,Bradley,-1
2021-05-22,@Bradley,1,3,Bradley,-2
2021-05-25,@Illinois State,10,9,Evansville,1
2021-05-26,@Indiana State,0,5,Indiana State,-5
2021-05-27,@Illinois State,5,6,Valparaiso,-1
2021-02-19,@Florida International,4,9,Florida International,-5
2021-02-20,@Florida International,10,6,Florida International,4
2021-02-20,@Florida International,3,4,Florida International,-1
2021-03-05,@Vanderbilt,0,15,Vanderbilt,-15
2021-03-06,@Vanderbilt,2,5,Vanderbilt,-3
2021-03-07,@Vanderbilt,2,4,Vanderbilt,-2
2021-03-12,@Illinois-Chicago,1,0,Wisconsin-Milwaukee,1
2021-03-12,@Illinois-Chicago,3,1,Wisconsin-Milwaukee,2
2021-03-13,@Illinois-Chicago,0,3,Wisconsin-Milwaukee,-3
2021-03-14,@Illinois-Chicago,4,5,Wisconsin-Milwaukee,-1
2021-03-19,@Illinois-Chicago,5,7,Wright State,-2
2021-03-20,@Illinois-Chicago,4,12,Wright State,-8
2021-03-20,@Illinois-Chicago,0,7,Wright State,-7
2021-03-21,@Illinois-Chicago,5,12,Wright State,-7
2021-03-26,@Oakland,8,2,Oakland,6
2021-03-27,@Oakland,11,6,Oakland,5
2021-03-28,@Oakland,15,2,Oakland,13
2021-03-28,@Oakland,5,2,Oakland,3
2021-04-02,@Youngstown State,6,0,Youngstown State,6
2021-04-02,@Youngstown State,1,2,Youngstown State,-1
2021-04-03,@Youngstown State,9,14,Youngstown State,-5
2021-04-03,@Youngstown State,9,13,Youngstown State,-4
2021-04-08,@Illinois-Chicago,15,11,Northern Kentucky,4
2021-04-09,@Illinois-Chicago,13,6,Northern Kentucky,7
2021-04-09,@Illinois-Chicago,5,8,Northern Kentucky,-3
2021-04-16,@Illinois-Chicago,1,0,IPFW,1
2021-04-17,@Illinois-Chicago,2,0,IPFW,2
2021-04-17,@Illinois-Chicago,4,2,IPFW,2
2021-04-18,@Illinois-Chicago,11,4,IPFW,7
2021-04-23,@Wisconsin-Milwaukee,3,1,Wisconsin-Milwaukee,2
2021-04-24,@Wisconsin-Milwaukee,10,3,Wisconsin-Milwaukee,7
2021-04-24,@Wisconsin-Milwaukee,10,1,Wisconsin-Milwaukee,9
2021-04-25,@Wisconsin-Milwaukee,7,0,Wisconsin-Milwaukee,7
2021-04-30,@Illinois-Chicago,0,1,Youngstown State,-1
2021-05-01,@Illinois-Chicago,8,7,Youngstown State,1
2021-05-01,@Illinois-Chicago,3,1,Youngstown State,2
2021-05-02,@Illinois-Chicago,18,7,Youngstown State,11
2021-05-14,@IPFW,22,7,IPFW,15
2021-05-15,@IPFW,20,2,IPFW,18
2021-05-15,@IPFW,18,6,IPFW,12
2021-05-16,@IPFW,10,0,IPFW,10
2021-05-21,@Northern Kentucky,8,6,Northern Kentucky,2
2021-05-22,@Northern Kentucky,5,4,Northern Kentucky,1
2021-05-22,@Northern Kentucky,24,10,Northern Kentucky,14
2021-05-23,@Northern Kentucky,10,7,Northern Kentucky,3
2021-05-27,@Illinois-Chicago,7,4,Youngstown State,3
2021-05-28,@Illinois-Chicago,11,14,Wisconsin-Milwaukee,-3
2021-05-28,@Wright State,4,15,Wright State,-11
2021-03-05,@Minnesota,5,2,Minnesota,3
2021-03-05,@Rutgers,1,2,Rutgers,-1
2021-03-06,@Indiana,4,2,Rutgers,2
2021-03-07,@Minnesota,8,1,Minnesota,7
2021-03-13,@Indiana,7,2,Penn State,5
2021-03-13,@Indiana,8,0,Penn State,8
2021-03-14,@Indiana,2,1,Penn State,1
2021-03-14,@Indiana,6,5,Penn State,1
2021-03-19,@Indiana,2,1,Purdue,1
2021-03-20,@Indiana,5,8,Purdue,-3
2021-03-21,@Indiana,9,4,Purdue,5
2021-03-26,@Michigan State,8,2,Michigan State,6
2021-03-27,@Michigan State,10,4,Michigan State,6
2021-03-28,@Michigan State,1,5,Michigan State,-4
2021-04-02,@Ohio State,2,3,Ohio State,-1
2021-04-03,@Ohio State,0,6,Ohio State,-6
2021-04-03,@Ohio State,2,5,Ohio State,-3
2021-04-04,@Ohio State,3,4,Ohio State,-1
2021-04-09,@Indiana,6,4,Illinois,2
2021-04-10,@Indiana,8,0,Illinois,8
2021-04-16,@Northwestern,5,4,Northwestern,1
2021-04-17,@Northwestern,5,8,Northwestern,-3
2021-04-18,@Northwestern,4,0,Northwestern,4
2021-04-23,@Indiana,9,3,Minnesota,6
2021-04-23,@Indiana,7,1,Minnesota,6
2021-04-25,@Indiana,23,1,Minnesota,22
2021-04-30,@Indiana,5,6,Iowa,-1
2021-05-01,@Indiana,12,6,Iowa,6
2021-05-02,@Indiana,12,8,Iowa,4
2021-05-07,@Rutgers,8,3,Rutgers,5
2021-05-08,@Nebraska,6,7,Nebraska,-1
2021-05-08,@Rutgers,5,3,Rutgers,2
2021-05-09,@Indiana,4,2,Nebraska,2
2021-05-14,@Michigan,3,10,Michigan,-7
2021-05-15,@Michigan,13,8,Michigan,5
2021-05-16,@Michigan,1,6,Michigan,-5
2021-05-18,@Indiana,2,3,Illinois,-1
2021-05-21,@Indiana,5,8,Nebraska,-3
2021-05-22,@Indiana,1,3,Nebraska,-2
2021-05-23,@Indiana,1,3,Ohio State,-2
2021-05-24,@Indiana,2,0,Ohio State,2
2021-05-29,@Maryland,3,4,Maryland,-1
2021-05-29,@Maryland,2,5,Maryland,-3
2021-05-30,@Maryland,7,3,Maryland,4
2021-02-19,@Pittsburgh,4,0,Pittsburgh,4
2021-02-20,@Indiana State,2,8,Pittsburgh,-6
2021-02-21,@Pittsburgh,1,10,Pittsburgh,-9
2021-02-26,@Tennessee,3,4,Tennessee,-1
2021-02-27,@Tennessee,7,5,Tennessee,2
2021-02-27,@Tennessee,3,1,Tennessee,2
2021-02-28,@Tennessee,5,6,Tennessee,-1
2021-03-05,@Florida International,13,2,Florida International,11
2021-03-07,@Florida International,7,2,Florida International,5
2021-03-07,@Florida International,9,4,Florida International,5
2021-03-09,@Florida Gulf Coast,5,3,Florida Gulf Coast,2
2021-03-11,@Florida Atlantic,7,5,Florida Atlantic,2
2021-03-12,@Florida Atlantic,10,2,Florida Atlantic,8
2021-03-13,@Florida Atlantic,5,7,Florida Atlantic,-2
2021-03-19,@Alabama-Birmingham,1,0,Alabama-Birmingham,1
2021-03-20,@Alabama-Birmingham,10,8,Alabama-Birmingham,2
2021-03-21,@Alabama-Birmingham,4,11,Alabama-Birmingham,-7
2021-04-01,@St. Louis,8,2,St. Louis,6
2021-04-02,@St. Louis,13,2,St. Louis,11
2021-04-03,@St. Louis,5,8,St. Louis,-3
2021-04-09,@Illinois State,6,1,Illinois State,5
2021-04-09,@Illinois State,4,2,Illinois State,2
2021-04-10,@Illinois State,0,5,Illinois State,-5
2021-04-11,@Illinois State,8,7,Illinois State,1
2021-04-16,@Indiana State,5,0,Valparaiso,5
2021-04-17,@Indiana State,6,2,Valparaiso,4
2021-04-17,@Indiana State,11,2,Valparaiso,9
2021-04-18,@Indiana State,12,1,Valparaiso,11
2021-04-23,@Dallas Baptist,5,8,Dallas Baptist,-3
2021-04-24,@Dallas Baptist,0,9,Dallas Baptist,-9
2021-04-24,@Dallas Baptist,5,6,Dallas Baptist,-1
2021-04-25,@Dallas Baptist,7,5,Dallas Baptist,2
2021-05-07,@Missouri State,7,2,Missouri State,5
2021-05-08,@Missouri State,3,4,Missouri State,-1
2021-05-09,@Missouri State,5,2,Missouri State,3
2021-05-09,@Missouri State,13,2,Missouri State,11
2021-05-14,@Indiana State,5,4,Southern Illinois,1
2021-05-15,@Indiana State,7,8,Southern Illinois,-1
2021-05-15,@Indiana State,4,11,Southern Illinois,-7
2021-05-16,@Indiana State,0,5,Southern Illinois,-5
2021-05-20,@Evansville,14,7,Evansville,7
2021-05-21,@Evansville,1,5,Evansville,-4
2021-05-21,@Evansville,4,5,Evansville,-1
2021-05-22,@Evansville,13,10,Evansville,3
2021-05-26,@Indiana State,5,0,Illinois State,5
2021-05-28,@Southern Illinois,11,8,Southern Illinois,3
2021-05-29,@Southern Illinois,9,7,Southern Illinois,2
2021-05-29,@Indiana State,1,10,Dallas Baptist,-9
2021-05-30,@Indiana State,8,12,Dallas Baptist,-4
2021-06-04,@Georgia Tech,6,7,Georgia Tech,-1
2021-06-05,@Indiana State,9,2,Presbyterian,7
2021-06-06,@Indiana State,0,9,Georgia Tech,-9
2021-03-21,@Siena,5,15,Siena,-10
2021-03-21,@Siena,3,4,Siena,-1
2021-03-22,@Siena,10,7,Siena,3
2021-03-22,@Siena,16,10,Siena,6
2021-03-27,@Iona,3,5,Canisius,-2
2021-03-27,@Iona,5,8,Canisius,-3
2021-03-28,@Iona,8,6,Canisius,2
2021-03-28,@Iona,0,5,Canisius,-5
2021-04-02,@Fairfield,2,4,Fairfield,-2
2021-04-02,@Fairfield,2,4,Fairfield,-2
2021-04-03,@Fairfield,2,10,Fairfield,-8
2021-04-03,@Fairfield,0,7,Fairfield,-7
2021-04-07,@Manhattan,1,13,Manhattan,-12
2021-04-07,@Manhattan,1,8,Manhattan,-7
2021-03-06,@Iowa,2,4,Michigan,-2
2021-03-07,@Iowa,8,3,Michigan,5
2021-03-07,@Iowa,0,7,Michigan,-7
2021-03-08,@Iowa,4,11,Michigan,-7
2021-03-12,@Iowa,4,0,Ohio State,4
2021-03-13,@Ohio State,4,7,Ohio State,-3
2021-03-13,@Nebraska,0,4,Nebraska,-4
2021-03-14,@Nebraska,3,1,Nebraska,2
2021-03-19,@Iowa,3,0,Nebraska,3
2021-03-20,@Iowa,8,10,Nebraska,-2
2021-03-21,@Iowa,8,13,Nebraska,-5
2021-03-26,@Ohio State,2,8,Ohio State,-6
2021-03-27,@Ohio State,5,1,Ohio State,4
2021-03-27,@Maryland,6,4,Maryland,2
2021-03-28,@Iowa,11,2,Maryland,9
2021-04-02,@Purdue,4,2,Purdue,2
2021-04-03,@Purdue,8,10,Purdue,-2
2021-04-04,@Purdue,8,5,Purdue,3
2021-04-09,@Iowa,7,1,Minnesota,6
2021-04-11,@Iowa,18,0,Minnesota,18
2021-04-11,@Iowa,6,1,Minnesota,5
2021-04-16,@Rutgers,14,12,Rutgers,2
2021-04-17,@Rutgers,3,1,Rutgers,2
2021-04-17,@Rutgers,8,1,Rutgers,7
2021-04-18,@Rutgers,7,8,Rutgers,-1
2021-04-23,@Iowa,6,2,Maryland,4
2021-04-24,@Iowa,6,8,Maryland,-2
2021-04-25,@Iowa,15,4,Northwestern,11
2021-04-26,@Iowa,12,9,Northwestern,3
2021-04-30,@Indiana,6,5,Indiana,1
2021-05-01,@Indiana,6,12,Indiana,-6
2021-05-02,@Indiana,8,12,Indiana,-4
2021-05-07,@Iowa,4,2,Penn State,2
2021-05-08,@Iowa,4,5,Penn State,-1
2021-05-08,@Iowa,5,3,Penn State,2
2021-05-14,@Iowa,5,4,Illinois,1
2021-05-15,@Iowa,1,14,Illinois,-13
2021-05-16,@Iowa,2,6,Illinois,-4
2021-05-21,@Northwestern,6,1,Northwestern,5
2021-05-22,@Northwestern,4,5,Northwestern,-1
2021-05-23,@Northwestern,6,8,Northwestern,-2
2021-05-28,@Michigan State,12,1,Michigan State,11
2021-05-29,@Michigan State,7,4,Michigan State,3
2021-05-30,@Michigan State,11,3,Michigan State,8
2021-02-20,@Mercer,0,10,Mercer,-10
2021-02-20,@Mercer,0,9,Mercer,-9
2021-02-21,@Mercer,0,14,Mercer,-14
2021-02-24,@Mississippi State,3,7,Mississippi State,-4
2021-02-26,@Jackson State,9,5,Arkansas-Pine Bluff,4
2021-02-27,@Jackson State,13,2,Arkansas-Pine Bluff,11
2021-02-28,@Jackson State,17,11,Arkansas-Pine Bluff,6
2021-03-03,@Mississippi,1,12,Mississippi,-11
2021-03-05,@Alabama State,8,7,Alabama State,1
2021-03-06,@Alabama State,3,2,Alabama State,1
2021-03-07,@Alabama State,4,3,Alabama State,1
2021-03-10,@Jackson State,16,6,Tougaloo,10
2021-03-12,@Alcorn State,7,2,Alcorn State,5
2021-03-13,@Alcorn State,10,5,Alcorn State,5
2021-03-14,@Alcorn State,30,6,Alcorn State,24
2021-03-17,@Grambling State,15,8,Grambling State,7
2021-03-24,@Jackson State,7,9,Grambling State,-2
2021-03-26,@Jackson State,14,3,Alabama A&M,11
2021-03-27,@Jackson State,16,0,Alabama A&M,16
2021-03-28,@Jackson State,6,2,Alabama A&M,4
2021-03-30,@Tulane,7,10,Tulane,-3
2021-04-02,@Mississippi Valley State,12,3,Mississippi Valley State,9
2021-04-03,@Mississippi Valley State,9,0,Mississippi Valley State,9
2021-04-04,@Mississippi Valley State,13,1,Mississippi Valley State,12
2021-04-06,@Jackson State,17,3,Tougaloo,14
2021-04-09,@Jackson State,8,3,Alabama State,5
2021-04-10,@Jackson State,9,8,Alabama State,1
2021-04-11,@Jackson State,4,2,Alabama State,2
2021-04-16,@Jackson State,10,0,Alcorn State,10
2021-04-17,@Jackson State,6,4,Alcorn State,2
2021-04-18,@Jackson State,11,0,Alcorn State,11
2021-04-21,@Louisiana-Monroe,6,18,Louisiana-Monroe,-12
2021-04-30,@Alabama A&M,13,0,Alabama A&M,13
2021-05-01,@Alabama A&M,9,3,Alabama A&M,6
2021-05-02,@Alabama A&M,9,3,Alabama A&M,6
2021-05-05,@Jackson State,4,2,Louisiana-Monroe,2
2021-05-07,@Jackson State,6,0,Mississippi Valley State,6
2021-05-08,@Jackson State,19,5,Mississippi Valley State,14
2021-05-09,@Jackson State,12,1,Mississippi Valley State,11
2021-05-19,@Jackson State,7,4,Texas Southern,3
2021-05-20,@Jackson State,14,13,Grambling State,1
2021-05-21,@Jackson State,9,5,Grambling State,4
2021-05-23,@Jackson State,6,7,Southern,-1
2021-02-20,@Jacksonville,4,8,"Miami, Ohio",-4
2021-02-20,@Jacksonville,1,4,"Miami, Ohio",-3
2021-02-21,@Jacksonville,2,5,"Miami, Ohio",-3
2021-02-23,@Jacksonville,2,7,Pittsburgh,-5
2021-02-26,@Troy,3,6,Troy,-3
2021-02-27,@Troy,1,8,Troy,-7
2021-02-28,@Troy,0,9,Troy,-9
2021-03-03,@Jacksonville,6,7,The Citadel,-1
2021-03-05,@Jacksonville,8,2,Wofford,6
2021-03-06,@Jacksonville,8,1,Wofford,7
2021-03-07,@Jacksonville,4,2,Wofford,2
2021-03-12,@Florida,10,9,Florida,1
2021-03-13,@Florida,0,9,Florida,-9
2021-03-14,@Florida,2,5,Florida,-3
2021-03-19,@Jacksonville,2,1,Central Florida,1
2021-03-20,@Jacksonville,9,12,Central Florida,-3
2021-03-21,@Central Florida,0,10,Central Florida,-10
2021-03-26,@Jacksonville,3,5,North Florida,-2
2021-03-27,@Jacksonville,6,13,North Florida,-7
2021-03-28,@Jacksonville,3,9,North Florida,-6
2021-03-30,@Central Florida,11,6,Central Florida,5
2021-04-01,@Jacksonville,1,11,Stetson,-10
2021-04-02,@Jacksonville,5,7,Stetson,-2
2021-04-03,@Jacksonville,2,3,Stetson,-1
2021-04-06,@Florida State,8,7,Florida State,1
2021-04-09,@Florida Gulf Coast,4,18,Florida Gulf Coast,-14
2021-04-10,@Florida Gulf Coast,7,9,Florida Gulf Coast,-2
2021-04-10,@Florida Gulf Coast,8,14,Florida Gulf Coast,-6
2021-04-14,@The Citadel,2,3,The Citadel,-1
2021-04-20,@Jacksonville,7,8,Florida,-1
2021-04-23,@North Florida,5,8,North Florida,-3
2021-04-24,@North Florida,4,10,North Florida,-6
2021-04-25,@North Florida,6,14,North Florida,-8
2021-04-27,@Georgia Southern,3,4,Georgia Southern,-1
2021-04-30,@Stetson,0,5,Stetson,-5
2021-05-01,@Stetson,7,5,Stetson,2
2021-05-02,@Stetson,5,2,Stetson,3
2021-05-07,@Jacksonville,5,2,Florida Gulf Coast,3
2021-05-08,@Jacksonville,5,7,Florida Gulf Coast,-2
2021-05-09,@Jacksonville,11,14,Florida Gulf Coast,-3
2021-05-14,@Jacksonville,12,2,North Florida,10
2021-05-15,@Stetson,3,15,Stetson,-12
2021-05-21,@Florida Gulf Coast,4,1,Florida Gulf Coast,3
2021-05-22,@Florida Gulf Coast,3,7,Florida Gulf Coast,-4
2021-05-23,@Florida Gulf Coast,17,1,Florida Gulf Coast,16
2021-05-27,@Liberty,2,1,Liberty,1
2021-05-28,@North Florida,8,5,North Florida,3
2021-05-29,@Jacksonville,7,3,Liberty,4
2021-06-04,@Old Dominion,3,4,Old Dominion,-1
2021-06-05,@Virginia,8,13,Virginia,-5
2021-02-19,@Jacksonville State,7,8,Southern Illinois,-1
2021-02-20,@Jacksonville State,5,3,Alabama State,2
2021-02-21,@Jacksonville State,4,5,Tennessee Tech,-1
2021-02-23,@Jacksonville State,2,5,Alabama,-3
2021-02-26,@Jacksonville State,5,4,Valparaiso,1
2021-02-27,@Jacksonville State,10,2,Valparaiso,8
2021-02-27,@Jacksonville State,13,3,Valparaiso,10
2021-03-03,@Samford,9,10,Samford,-1
2021-03-05,@Jacksonville State,6,0,Southern Mississippi,6
2021-03-06,@Jacksonville State,0,6,Southern Mississippi,-6
2021-03-07,@Jacksonville State,1,3,Southern Mississippi,-2
2021-03-10,@Alabama,2,7,Alabama,-5
2021-03-12,@South Alabama,11,2,South Alabama,9
2021-03-13,@South Alabama,8,2,South Alabama,6
2021-03-14,@South Alabama,5,7,South Alabama,-2
2021-03-19,@Murray State,2,3,Murray State,-1
2021-03-20,@Murray State,0,11,Murray State,-11
2021-03-20,@Murray State,16,11,Murray State,5
2021-03-24,@Kennesaw State,10,12,Kennesaw State,-2
2021-03-26,@Jacksonville State,8,3,Tennessee Tech,5
2021-03-27,@Jacksonville State,5,0,Tennessee Tech,5
2021-03-27,@Jacksonville State,8,0,Tennessee Tech,8
2021-03-30,@Jacksonville State,4,5,Samford,-1
2021-04-02,@Southeast Missouri State,5,6,Southeast Missouri State,-1
2021-04-03,@Southeast Missouri State,3,8,Southeast Missouri State,-5
2021-04-03,@Southeast Missouri State,8,4,Southeast Missouri State,4
2021-04-07,@Alabama State,14,10,Alabama State,4
2021-04-10,@Jacksonville State,3,5,Belmont,-2
2021-04-10,@Jacksonville State,8,4,Belmont,4
2021-04-11,@Jacksonville State,7,2,Belmont,5
2021-04-13,@Jacksonville State,8,4,Kennesaw State,4
2021-04-16,@Eastern Kentucky,0,1,Eastern Kentucky,-1
2021-04-17,@Eastern Kentucky,5,9,Eastern Kentucky,-4
2021-04-17,@Eastern Kentucky,11,1,Eastern Kentucky,10
2021-04-20,@Jacksonville State,6,1,Troy,5
2021-04-21,@Auburn,7,8,Auburn,-1
2021-04-24,@Jacksonville State,9,5,Morehead State,4
2021-04-24,@Jacksonville State,0,3,Morehead State,-3
2021-04-25,@Jacksonville State,3,6,Morehead State,-3
2021-04-27,@Troy,0,2,Troy,-2
2021-04-30,@Tennessee-Martin,6,1,Tennessee-Martin,5
2021-05-01,@Tennessee-Martin,14,4,Tennessee-Martin,10
2021-05-01,@Tennessee-Martin,12,8,Tennessee-Martin,4
2021-05-07,@Jacksonville State,3,4,Southern Illinois-Edwardsville,-1
2021-05-08,@Jacksonville State,2,4,Southern Illinois-Edwardsville,-2
2021-05-08,@Jacksonville State,10,0,Southern Illinois-Edwardsville,10
2021-05-14,@Austin Peay State,7,8,Austin Peay State,-1
2021-05-15,@Austin Peay State,10,4,Austin Peay State,6
2021-05-15,@Austin Peay State,1,5,Austin Peay State,-4
2021-05-18,@Mississippi State,1,6,Mississippi State,-5
2021-05-20,@Jacksonville State,4,7,Eastern Illinois,-3
2021-05-21,@Jacksonville State,10,0,Eastern Illinois,10
2021-05-21,@Jacksonville State,4,2,Eastern Illinois,2
2021-02-19,@North Carolina,1,8,North Carolina,-7
2021-02-20,@North Carolina,4,7,North Carolina,-3
2021-02-21,@North Carolina,2,3,North Carolina,-1
2021-03-05,@James Madison,6,10,Bowling Green State,-4
2021-03-06,@James Madison,15,4,Bowling Green State,11
2021-03-07,@James Madison,4,10,Bowling Green State,-6
2021-03-11,@James Madison,9,5,VMI,4
2021-03-13,@VMI,7,17,VMI,-10
2021-03-14,@VMI,12,7,VMI,5
2021-04-02,@James Madison,9,3,College of Charleston,6
2021-04-03,@James Madison,7,4,College of Charleston,3
2021-04-04,@James Madison,1,3,College of Charleston,-2
2021-04-16,@College of Charleston,7,14,College of Charleston,-7
2021-04-17,@College of Charleston,3,15,College of Charleston,-12
2021-04-18,@College of Charleston,7,1,College of Charleston,6
2021-04-24,@William and Mary,9,5,William and Mary,4
2021-04-25,@William and Mary,3,10,William and Mary,-7
2021-04-25,@William and Mary,0,1,William and Mary,-1
2021-05-02,@James Madison,9,8,St. Joseph's,1
2021-05-02,@James Madison,9,8,St. Joseph's,1
2021-05-07,@North Carolina-Wilmington,3,5,North Carolina-Wilmington,-2
2021-05-08,@North Carolina-Wilmington,5,12,North Carolina-Wilmington,-7
2021-05-09,@North Carolina-Wilmington,1,5,North Carolina-Wilmington,-4
2021-05-15,@James Madison,10,7,William and Mary,3
2021-05-15,@James Madison,4,7,William and Mary,-3
2021-05-16,@James Madison,10,9,William and Mary,1
2021-05-20,@James Madison,18,20,Virginia Commonwealth,-2
2021-05-21,@James Madison,1,10,Virginia Commonwealth,-9
2021-02-19,@Kansas,7,3,South Dakota State,4
2021-02-20,@Kansas,5,8,South Dakota State,-3
2021-02-21,@Kansas,13,1,South Dakota State,12
2021-02-26,@Florida Gulf Coast,5,3,Florida Gulf Coast,2
2021-02-27,@Florida Gulf Coast,5,6,Florida Gulf Coast,-1
2021-02-28,@Florida Gulf Coast,2,3,Florida Gulf Coast,-1
2021-02-28,@Florida Gulf Coast,0,2,Florida Gulf Coast,-2
2021-03-05,@St. Louis,1,8,St. Louis,-7
2021-03-06,@St. Louis,5,1,St. Louis,4
2021-03-07,@St. Louis,7,5,St. Louis,2
2021-03-12,@Nebraska-Omaha,7,9,Nebraska-Omaha,-2
2021-03-12,@Nebraska-Omaha,7,3,Nebraska-Omaha,4
2021-03-13,@Nebraska-Omaha,10,7,Nebraska-Omaha,3
2021-03-13,@Nebraska-Omaha,9,0,Nebraska-Omaha,9
2021-03-19,@Kansas,7,6,Creighton,1
2021-03-20,@Kansas,11,3,Creighton,8
2021-03-20,@Kansas,11,3,Creighton,8
2021-03-21,@Kansas,7,4,Creighton,3
2021-03-23,@Lafayette,20,5,Lafayette,15
2021-03-26,@West Virginia,0,11,West Virginia,-11
2021-03-27,@West Virginia,9,2,West Virginia,7
2021-03-27,@West Virginia,2,15,West Virginia,-13
2021-03-30,@Kansas,10,9,Missouri,1
2021-04-01,@Kansas,2,5,Texas,-3
2021-04-02,@Kansas,0,7,Texas,-7
2021-04-03,@Kansas,2,11,Texas,-9
2021-04-06,@Kansas,8,0,Texas Southern,8
2021-04-06,@Kansas,8,1,Texas Southern,7
2021-04-09,@Oklahoma,4,10,Oklahoma,-6
2021-04-10,@Oklahoma,8,7,Oklahoma,1
2021-04-11,@Oklahoma,3,14,Oklahoma,-11
2021-04-13,@Kansas,13,3,Air Force,10
2021-04-14,@Kansas,7,4,Air Force,3
2021-04-17,@Kansas,2,6,Baylor,-4
2021-04-17,@Kansas,2,8,Baylor,-6
2021-04-18,@Kansas,3,2,Baylor,1
2021-04-21,@Texas-Arlington,1,8,Texas-Arlington,-7
2021-04-23,@Texas Christian,1,15,Texas Christian,-14
2021-04-24,@Texas Christian,3,10,Texas Christian,-7
2021-04-25,@Texas Christian,2,1,Texas Christian,1
2021-04-27,@Kansas,6,11,Sacramento State,-5
2021-04-28,@Kansas,6,4,Sacramento State,2
2021-04-30,@Kansas,3,5,North Dakota State,-2
2021-05-01,@Kansas,10,2,North Dakota State,8
2021-05-02,@Kansas,3,5,North Dakota State,-2
2021-05-05,@Kansas,3,1,Missouri State,2
2021-05-07,@Kansas,4,13,Oklahoma State,-9
2021-05-08,@Kansas,0,19,Oklahoma State,-19
2021-05-09,@Kansas,8,7,Oklahoma State,1
2021-05-14,@Kansas,2,0,Kansas State,2
2021-05-14,@Kansas,10,0,Kansas State,10
2021-05-15,@Kansas,2,6,Kansas State,-4
2021-05-18,@Missouri,9,8,Missouri,1
2021-05-20,@Texas Tech,7,4,Texas Tech,3
2021-05-21,@Texas Tech,4,13,Texas Tech,-9
2021-05-22,@Texas Tech,0,5,Texas Tech,-5
2021-05-25,@West Virginia,7,8,West Virginia,-1
2021-02-19,@Oregon State,3,2,Oregon State,1
2021-02-20,@Kansas State,5,17,Gonzaga,-12
2021-02-21,@New Mexico,3,4,New Mexico,-1
2021-02-22,@Gonzaga,6,1,Gonzaga,5
2021-02-26,@Kansas State,9,8,Western Michigan,1
2021-02-27,@Kansas State,11,3,Western Michigan,8
2021-02-28,@Kansas State,2,1,Western Michigan,1
2021-03-05,@Kansas State,6,3,Eastern Illinois,3
2021-03-06,@Kansas State,5,6,Eastern Illinois,-1
2021-03-07,@Kansas State,7,14,Eastern Illinois,-7
2021-03-09,@Kansas State,15,4,South Dakota State,11
2021-03-10,@Kansas State,10,0,South Dakota State,10
2021-03-12,@Kansas State,4,3,Northern Illinois,1
2021-03-13,@Northern Illinois,3,1,Northern Illinois,2
2021-03-13,@Rice,8,3,Rice,5
2021-03-14,@Rice,0,1,Rice,-1
2021-03-19,@Kansas State,7,1,New Mexico,6
2021-03-20,@Kansas State,4,6,New Mexico,-2
2021-03-21,@Kansas State,17,8,New Mexico,9
2021-03-23,@Wichita State,1,5,Wichita State,-4
2021-03-26,@Oklahoma State,5,14,Oklahoma State,-9
2021-03-27,@Oklahoma State,2,4,Oklahoma State,-2
2021-03-28,@Oklahoma State,2,8,Oklahoma State,-6
2021-04-01,@Kansas State,1,17,Texas Tech,-16
2021-04-02,@Kansas State,7,2,Texas Tech,5
2021-04-03,@Kansas State,10,4,Texas Tech,6
2021-04-06,@Kansas State,12,2,Arkansas-Pine Bluff,10
2021-04-07,@Kansas State,12,0,Arkansas-Pine Bluff,12
2021-04-09,@Texas,6,13,Texas,-7
2021-04-10,@Texas,1,15,Texas,-14
2021-04-11,@Texas,2,9,Texas,-7
2021-04-13,@Kansas State,8,2,Northern Colorado,6
2021-04-14,@Kansas State,10,3,Northern Colorado,7
2021-04-17,@Kansas State,4,6,Oklahoma,-2
2021-04-17,@Kansas State,3,2,Oklahoma,1
2021-04-18,@Kansas State,8,3,Oklahoma,5
2021-04-23,@Kansas State,3,4,West Virginia,-1
2021-04-24,@Kansas State,5,2,West Virginia,3
2021-04-25,@Kansas State,9,4,West Virginia,5
2021-04-27,@Kansas State,13,8,Missouri,5
2021-04-30,@Kansas State,16,4,Texas Southern,12
2021-05-01,@Kansas State,15,6,Texas Southern,9
2021-05-02,@Kansas State,16,1,Texas Southern,15
2021-05-07,@Baylor,2,17,Baylor,-15
2021-05-08,@Baylor,10,3,Baylor,7
2021-05-09,@Baylor,3,23,Baylor,-20
2021-05-14,@Kansas,0,2,Kansas,-2
2021-05-14,@Kansas,0,10,Kansas,-10
2021-05-15,@Kansas,6,2,Kansas,4
2021-05-20,@Kansas State,4,2,Texas Christian,2
2021-05-21,@Kansas State,6,8,Texas Christian,-2
2021-05-22,@Kansas State,11,8,Texas Christian,3
2021-05-26,@Texas Christian,6,7,Texas Christian,-1
2021-05-27,@Baylor,9,4,Baylor,5
2021-05-28,@Texas Tech,7,2,Texas Tech,5
2021-05-29,@Texas Christian,5,2,Texas Christian,3
2021-05-29,@Texas Christian,7,17,Texas Christian,-10
2021-02-19,@Kennesaw State,7,8,St. Louis,-1
2021-02-20,@Kennesaw State,2,1,St. Louis,1
2021-02-20,@Kennesaw State,5,1,St. Louis,4
2021-02-21,@Kennesaw State,5,4,St. Louis,1
2021-02-26,@West Virginia,3,13,West Virginia,-10
2021-02-27,@Kennesaw State,7,6,Bryant,1
2021-02-28,@Coastal Carolina,11,13,Coastal Carolina,-2
2021-03-03,@Kennesaw State,6,4,Georgia,2
2021-03-05,@Alabama-Birmingham,3,2,Alabama-Birmingham,1
2021-03-06,@Alabama-Birmingham,9,3,Alabama-Birmingham,6
2021-03-07,@Alabama-Birmingham,7,8,Alabama-Birmingham,-1
2021-03-10,@Western Carolina,11,12,Western Carolina,-1
2021-03-12,@Kennesaw State,9,1,Bellarmine,8
2021-03-13,@Kennesaw State,9,3,Bellarmine,6
2021-03-14,@Kennesaw State,17,8,Bellarmine,9
2021-03-19,@Lipscomb,5,6,Lipscomb,-1
2021-03-20,@Lipscomb,15,2,Lipscomb,13
2021-03-21,@Lipscomb,0,14,Lipscomb,-14
2021-03-23,@Georgia,2,3,Georgia,-1
2021-03-24,@Kennesaw State,12,10,Jacksonville State,2
2021-03-26,@Georgia State,5,1,Georgia State,4
2021-03-27,@Georgia State,7,4,Georgia State,3
2021-03-28,@Kennesaw State,16,4,Georgia State,12
2021-03-29,@Kennesaw State,5,1,Georgia State,4
2021-04-09,@North Alabama,8,2,North Alabama,6
2021-04-10,@North Alabama,11,3,North Alabama,8
2021-04-11,@North Alabama,14,4,North Alabama,10
2021-04-13,@Jacksonville State,4,8,Jacksonville State,-4
2021-04-16,@Bellarmine,5,2,Bellarmine,3
2021-04-17,@Bellarmine,3,1,Bellarmine,2
2021-04-18,@Bellarmine,11,7,Bellarmine,4
2021-04-21,@Kennesaw State,5,11,Georgia Southern,-6
2021-04-23,@Kennesaw State,7,2,Lipscomb,5
2021-04-25,@Kennesaw State,4,8,Lipscomb,-4
2021-04-25,@Kennesaw State,7,0,Lipscomb,7
2021-04-28,@Kennesaw State,10,12,Mercer,-2
2021-04-30,@Georgia Tech,5,1,Georgia Tech,4
2021-05-01,@Georgia Tech,5,13,Georgia Tech,-8
2021-05-02,@Kennesaw State,10,5,Georgia Tech,5
2021-05-05,@Mercer,0,10,Mercer,-10
2021-05-07,@Liberty,0,4,Liberty,-4
2021-05-08,@Liberty,5,6,Liberty,-1
2021-05-09,@Liberty,1,4,Liberty,-3
2021-05-14,@Kennesaw State,1,3,Liberty,-2
2021-05-15,@Kennesaw State,11,12,Liberty,-1
2021-05-16,@Kennesaw State,7,4,Liberty,3
2021-05-18,@Kennesaw State,4,5,Wofford,-1
2021-05-21,@Kennesaw State,14,1,Lipscomb,13
2021-05-22,@Kennesaw State,10,2,Lipscomb,8
2021-05-27,@North Florida,5,6,North Florida,-1
2021-05-28,@Liberty,0,6,Liberty,-6
2021-02-21,@Virginia Tech,1,3,Virginia Tech,-2
2021-02-21,@Virginia Tech,2,9,Virginia Tech,-7
2021-02-27,@Kent State,17,5,Tennessee Tech,12
2021-02-27,@Kent State,6,1,Tennessee Tech,5
2021-02-28,@Kent State,8,1,Tennessee Tech,7
2021-03-05,@Mississippi State,3,8,Mississippi State,-5
2021-03-06,@Mississippi State,9,5,Mississippi State,4
2021-03-07,@Mississippi State,0,13,Mississippi State,-13
2021-03-12,@Kent State,10,7,Seton Hall,3
2021-03-13,@Kent State,12,4,Seton Hall,8
2021-03-14,@Kent State,4,7,Seton Hall,-3
2021-03-19,@Kent State,3,6,Northern Illinois,-3
2021-03-20,@Kent State,0,3,Northern Illinois,-3
2021-03-20,@Kent State,1,2,Northern Illinois,-1
2021-03-21,@Kent State,8,4,Northern Illinois,4
2021-03-26,@Dayton,2,14,Dayton,-12
2021-03-27,@Dayton,11,3,Dayton,8
2021-03-28,@Kent State,5,10,Dayton,-5
2021-03-28,@Kent State,0,4,Dayton,-4
2021-04-02,@Bowling Green State,14,1,Bowling Green State,13
2021-04-03,@Bowling Green State,13,4,Bowling Green State,9
2021-04-03,@Bowling Green State,10,6,Bowling Green State,4
2021-04-04,@Bowling Green State,10,5,Bowling Green State,5
2021-04-09,@Kent State,7,8,Toledo,-1
2021-04-10,@Kent State,8,9,Toledo,-1
2021-04-10,@Kent State,9,8,Toledo,1
2021-04-11,@Kent State,14,15,Toledo,-1
2021-04-16,@Central Michigan,0,10,Central Michigan,-10
2021-04-17,@Central Michigan,1,3,Central Michigan,-2
2021-04-17,@Central Michigan,1,2,Central Michigan,-1
2021-04-18,@Central Michigan,6,4,Central Michigan,2
2021-04-23,"@Miami, Ohio",0,1,"Miami, Ohio",-1
2021-04-23,"@Miami, Ohio",3,2,"Miami, Ohio",1
2021-04-24,"@Miami, Ohio",4,1,"Miami, Ohio",3
2021-04-25,"@Miami, Ohio",6,3,"Miami, Ohio",3
2021-04-30,@Kent State,3,2,Ohio,1
2021-05-01,@Kent State,6,12,Ohio,-6
2021-05-01,@Kent State,10,4,Ohio,6
2021-05-02,@Kent State,1,12,Ohio,-11
2021-05-07,@Kent State,13,3,Akron,10
2021-05-08,@Kent State,1,2,Akron,-1
2021-05-08,@Kent State,10,2,Akron,8
2021-05-10,@Kent State,8,3,Akron,5
2021-05-14,@Ball State,2,8,Ball State,-6
2021-05-15,@Ball State,9,4,Ball State,5
2021-05-15,@Ball State,7,8,Ball State,-1
2021-05-16,@Ball State,19,8,Ball State,11
2021-05-21,@Kent State,14,4,Western Michigan,10
2021-05-22,@Kent State,5,6,Western Michigan,-1
2021-05-22,@Kent State,9,2,Western Michigan,7
2021-05-23,@Kent State,11,10,Western Michigan,1
2021-05-25,@Kent State,6,9,Akron,-3
2021-05-28,@Eastern Michigan,4,5,Eastern Michigan,-1
2021-05-29,@Eastern Michigan,9,5,Eastern Michigan,4
2021-05-29,@Eastern Michigan,4,3,Eastern Michigan,1
2021-05-30,@Eastern Michigan,4,2,Eastern Michigan,2
2021-02-23,@Kentucky,5,1,"Miami, Ohio",4
2021-02-26,@Kentucky,10,0,Wisconsin-Milwaukee,10
2021-02-27,@Kentucky,4,2,Wisconsin-Milwaukee,2
2021-02-27,@Kentucky,9,3,Wisconsin-Milwaukee,6
2021-03-02,@Kentucky,6,3,Eastern Kentucky,3
2021-03-03,@Kentucky,8,5,Evansville,3
2021-03-05,@Kentucky,2,3,Ball State,-1
2021-03-06,@Kentucky,6,0,Ball State,6
2021-03-07,@Kentucky,3,4,Ball State,-1
2021-03-09,@Kentucky,6,5,Western Kentucky,1
2021-03-12,@Kentucky,16,1,Georgia State,15
2021-03-13,@Kentucky,6,1,Georgia State,5
2021-03-14,@Kentucky,4,2,Georgia State,2
2021-03-16,@Kentucky,8,13,Murray State,-5
2021-03-19,@Kentucky,10,2,Missouri,8
2021-03-20,@Kentucky,5,4,Missouri,1
2021-03-21,@Kentucky,3,5,Missouri,-2
2021-03-23,@Kentucky,6,5,Butler,1
2021-03-26,@Auburn,8,6,Auburn,2
2021-03-27,@Auburn,6,4,Auburn,2
2021-03-27,@Auburn,7,6,Auburn,1
2021-03-30,@Kentucky,4,3,Bellarmine,1
2021-04-01,@Mississippi State,1,8,Mississippi State,-7
2021-04-02,@Mississippi State,2,3,Mississippi State,-1
2021-04-03,@Mississippi State,3,4,Mississippi State,-1
2021-04-06,@Louisville,11,7,Louisville,4
2021-04-09,@Kentucky,2,15,Louisiana State,-13
2021-04-10,@Kentucky,6,8,Louisiana State,-2
2021-04-11,@Kentucky,13,4,Louisiana State,9
2021-04-13,@Kentucky,12,0,Bellarmine,12
2021-04-16,@Georgia,6,1,Georgia,5
2021-04-17,@Georgia,7,8,Georgia,-1
2021-04-18,@Georgia,6,17,Georgia,-11
2021-04-20,@Kentucky,5,12,Louisville,-7
2021-04-23,@Kentucky,1,10,Alabama,-9
2021-04-25,@Kentucky,5,2,Alabama,3
2021-04-25,@Kentucky,11,0,Alabama,11
2021-04-27,@Kentucky,7,6,Eastern Kentucky,1
2021-04-29,@Tennessee,4,14,Tennessee,-10
2021-04-30,@Tennessee,8,2,Tennessee,6
2021-05-01,@Tennessee,2,11,Tennessee,-9
2021-05-06,@Kentucky,7,5,Florida,2
2021-05-07,@Kentucky,5,8,Florida,-3
2021-05-08,@Kentucky,2,9,Florida,-7
2021-05-14,@Kentucky,6,12,South Carolina,-6
2021-05-15,@Kentucky,0,9,South Carolina,-9
2021-05-16,@Kentucky,6,11,South Carolina,-5
2021-05-18,@Kentucky,8,4,Tennessee Tech,4
2021-05-20,@Vanderbilt,2,4,Vanderbilt,-2
2021-05-21,@Vanderbilt,2,8,Vanderbilt,-6
2021-05-22,@Vanderbilt,7,5,Vanderbilt,2
2021-05-25,@Florida,1,4,Florida,-3
2021-02-26,@LaSalle,0,7,Hofstra,-7
2021-02-26,@LaSalle,2,4,Hofstra,-2
2021-03-01,@LaSalle,6,5,Hofstra,1
2021-03-01,@LaSalle,5,14,Hofstra,-9
2021-03-02,@LaSalle,10,6,Delaware State,4
2021-03-06,@Bucknell,5,4,Bucknell,1
2021-03-06,@Bucknell,7,0,Bucknell,7
2021-03-07,@Delaware,4,14,Delaware,-10
2021-03-07,@Delaware,4,7,Delaware,-3
2021-03-13,@LaSalle,4,2,George Mason,2
2021-03-13,@LaSalle,5,10,George Mason,-5
2021-03-14,@LaSalle,11,10,Coppin State,1
2021-03-20,@George Mason,7,1,George Mason,6
2021-03-20,@George Mason,3,8,George Mason,-5
2021-03-23,@Mount St. Mary's,8,4,Mount St. Mary's,4
2021-03-27,@St. Bonaventure,6,3,St. Bonaventure,3
2021-03-27,@St. Bonaventure,4,1,St. Bonaventure,3
2021-04-01,@Pennsylvania,14,7,Pennsylvania,7
2021-04-02,@Pennsylvania,22,2,Pennsylvania,20
2021-04-03,@Pennsylvania,7,15,Pennsylvania,-8
2021-04-03,@Pennsylvania,4,5,Pennsylvania,-1
2021-04-07,@Coppin State,16,8,Coppin State,8
2021-04-09,@LaSalle,8,5,Rhode Island,3
2021-04-10,@LaSalle,2,4,Rhode Island,-2
2021-04-10,@LaSalle,6,12,Rhode Island,-6
2021-04-11,@LaSalle,7,3,Rhode Island,4
2021-04-14,@LaSalle,6,4,Pennsylvania,2
2021-04-17,@Massachusetts,3,0,Massachusetts,3
2021-04-17,@Massachusetts,8,5,Massachusetts,3
2021-04-18,@Massachusetts,11,6,Massachusetts,5
2021-04-18,@Massachusetts,4,3,Massachusetts,1
2021-04-20,@Pennsylvania,7,8,Pennsylvania,-1
2021-04-21,@LaSalle,18,6,Lehigh,12
2021-04-23,@LaSalle,10,2,St. Bonaventure,8
2021-04-24,@LaSalle,3,2,St. Bonaventure,1
2021-04-24,@LaSalle,0,2,St. Bonaventure,-2
2021-04-25,@LaSalle,8,2,St. Bonaventure,6
2021-04-27,@Towson,16,11,Towson,5
2021-04-30,@LaSalle,7,6,Pennsylvania,1
2021-05-01,@LaSalle,3,16,Pennsylvania,-13
2021-05-01,@LaSalle,6,7,Pennsylvania,-1
2021-05-07,@LaSalle,5,0,St. Joseph's,5
2021-05-08,@LaSalle,8,3,St. Joseph's,5
2021-05-08,@LaSalle,3,4,St. Joseph's,-1
2021-05-09,@LaSalle,14,5,St. Joseph's,9
2021-05-14,@Fordham,14,2,Fordham,12
2021-05-15,@Fordham,8,4,Fordham,4
2021-05-15,@Fordham,2,4,Fordham,-2
2021-05-16,@Fordham,9,5,Fordham,4
2021-05-20,@St. Joseph's,2,3,St. Joseph's,-1
2021-05-21,@St. Joseph's,2,3,St. Joseph's,-1
2021-05-21,@St. Joseph's,2,11,St. Joseph's,-9
2021-05-22,@St. Joseph's,2,5,St. Joseph's,-3
2021-03-06,@Lafayette,5,3,Wagner,2
2021-03-06,@Lafayette,12,14,Wagner,-2
2021-03-20,@Lafayette,3,1,Holy Cross,2
2021-03-21,@Lafayette,11,9,Holy Cross,2
2021-03-21,@Lafayette,4,0,Holy Cross,4
2021-03-23,@Lafayette,5,20,Kansas,-15
2021-03-27,@Lafayette,3,8,Lehigh,-5
2021-03-27,@Lafayette,1,4,Lehigh,-3
2021-04-03,@Army,3,12,Army,-9
2021-04-03,@Army,4,5,Army,-1
2021-04-04,@Lafayette,5,6,Army,-1
2021-04-04,@Lafayette,1,6,Army,-5
2021-04-07,@Lehigh,6,7,Lehigh,-1
2021-04-10,@Lafayette,8,6,Navy,2
2021-04-10,@Lafayette,13,12,Navy,1
2021-04-11,@Navy,4,8,Navy,-4
2021-04-11,@Navy,8,10,Navy,-2
2021-04-14,@Lehigh,3,2,Lehigh,1
2021-04-17,@Lafayette,6,2,Holy Cross,4
2021-04-18,@Lafayette,5,2,Holy Cross,3
2021-04-18,@Lafayette,4,5,Holy Cross,-1
2021-04-23,@Lafayette,14,13,Army,1
2021-04-23,@Lafayette,1,16,Army,-15
2021-04-24,@Army,4,2,Army,2
2021-04-24,@Army,5,6,Army,-1
2021-05-08,@Bucknell,4,3,Bucknell,1
2021-05-08,@Bucknell,10,4,Bucknell,6
2021-05-09,@Lafayette,8,13,Bucknell,-5
2021-05-15,@Army,10,1,Army,9
2021-05-15,@Army,6,8,Army,-2
2021-05-16,@Army,3,7,Army,-4
2021-03-03,@Lamar,2,0,Houston,2
2021-03-05,@Lamar,4,1,Stephen F. Austin State,3
2021-03-06,@Lamar,5,1,Stephen F. Austin State,4
2021-03-07,@Lamar,3,2,Stephen F. Austin State,1
2021-03-10,@Tarleton State,6,10,Tarleton State,-4
2021-03-11,@Texas-Arlington,3,0,Texas-Arlington,3
2021-03-12,@Texas-Arlington,2,0,Texas-Arlington,2
2021-03-13,@Texas-Arlington,3,11,Texas-Arlington,-8
2021-03-14,@Texas-Arlington,4,0,Texas-Arlington,4
2021-03-16,@Southern,7,5,Southern,2
2021-03-19,@Lamar,7,5,Central Arkansas,2
2021-03-20,@Lamar,7,2,Central Arkansas,5
2021-03-20,@Lamar,2,5,Central Arkansas,-3
2021-03-21,@Lamar,1,6,Central Arkansas,-5
2021-03-26,@Lamar,0,3,Southeastern Louisiana,-3
2021-03-27,@Lamar,5,6,Southeastern Louisiana,-1
2021-03-27,@Lamar,2,6,Southeastern Louisiana,-4
2021-03-28,@Lamar,8,9,Southeastern Louisiana,-1
2021-04-01,@Houston Baptist,13,3,Houston Baptist,10
2021-04-02,@Houston Baptist,15,4,Houston Baptist,11
2021-04-02,@Houston Baptist,2,3,Houston Baptist,-1
2021-04-03,@Houston Baptist,12,0,Houston Baptist,12
2021-04-10,@Northwestern State,7,11,Northwestern State,-4
2021-04-10,@Northwestern State,16,4,Northwestern State,12
2021-04-11,@Northwestern State,1,8,Northwestern State,-7
2021-04-11,@Northwestern State,3,2,Northwestern State,1
2021-04-17,@Lamar,3,10,Nicholls State,-7
2021-04-17,@Lamar,11,2,Nicholls State,9
2021-04-18,@Lamar,5,2,Nicholls State,3
2021-04-18,@Lamar,2,3,Nicholls State,-1
2021-04-30,@Lamar,7,11,Texas A&M-Corpus Christi,-4
2021-04-30,@Lamar,0,6,Texas A&M-Corpus Christi,-6
2021-05-01,@Lamar,7,3,Texas A&M-Corpus Christi,4
2021-05-02,@Lamar,6,3,Texas A&M-Corpus Christi,3
2021-05-07,@Abilene Christian,2,3,Abilene Christian,-1
2021-05-08,@Abilene Christian,5,10,Abilene Christian,-5
2021-05-08,@Abilene Christian,4,8,Abilene Christian,-4
2021-05-09,@Abilene Christian,5,7,Abilene Christian,-2
2021-05-14,@Lamar,6,0,New Orleans,6
2021-05-15,@Lamar,0,2,New Orleans,-2
2021-05-15,@Lamar,3,2,New Orleans,1
2021-05-16,@Lamar,6,4,New Orleans,2
2021-05-20,@Incarnate Word,7,0,Incarnate Word,7
2021-05-20,@Incarnate Word,13,4,Incarnate Word,9
2021-05-21,@Incarnate Word,4,6,Incarnate Word,-2
2021-05-22,@Incarnate Word,13,3,Incarnate Word,10
2021-05-26,@Abilene Christian,1,7,Abilene Christian,-6
2021-05-27,@Sam Houston State,4,7,Sam Houston State,-3
2021-02-27,@Coppin State,10,1,Coppin State,9
2021-02-27,@Coppin State,9,0,Coppin State,9
2021-03-06,@George Washington,2,9,George Washington,-7
2021-03-06,@George Washington,1,4,George Washington,-3
2021-03-07,@Lehigh,9,13,George Washington,-4
2021-03-07,@Lehigh,3,4,George Washington,-1
2021-03-13,@Lehigh,5,4,Bucknell,1
2021-03-13,@Lehigh,3,4,Bucknell,-1
2021-03-14,@Bucknell,17,10,Bucknell,7
2021-03-20,@Lehigh,3,2,Delaware,1
2021-03-20,@Lehigh,0,5,Delaware,-5
2021-03-27,@Lafayette,8,3,Lafayette,5
2021-03-27,@Lafayette,4,1,Lafayette,3
2021-04-03,@Navy,5,1,Navy,4
2021-04-03,@Navy,3,4,Navy,-1
2021-04-04,@Lehigh,3,1,Navy,2
2021-04-07,@Lehigh,7,6,Lafayette,1
2021-04-10,@Bucknell,6,3,Bucknell,3
2021-04-10,@Bucknell,9,8,Bucknell,1
2021-04-12,@Lehigh,2,8,Bucknell,-6
2021-04-14,@Lehigh,2,3,Lafayette,-1
2021-04-17,@Lehigh,2,6,Army,-4
2021-04-17,@Lehigh,4,5,Army,-1
2021-04-18,@Army,11,9,Army,2
2021-04-18,@Army,4,3,Army,1
2021-04-21,@LaSalle,6,18,LaSalle,-12
2021-04-24,@Lehigh,7,4,Bucknell,3
2021-04-24,@Lehigh,1,3,Bucknell,-2
2021-04-25,@Bucknell,4,14,Bucknell,-10
2021-04-28,@Lehigh,7,6,Fairleigh Dickinson,1
2021-05-01,@Lehigh,8,4,Navy,4
2021-05-01,@Lehigh,2,0,Navy,2
2021-05-02,@Navy,2,7,Navy,-5
2021-05-08,@Holy Cross,5,4,Holy Cross,1
2021-05-08,@Holy Cross,5,0,Holy Cross,5
2021-05-09,@Holy Cross,7,9,Holy Cross,-2
2021-05-09,@Holy Cross,4,1,Holy Cross,3
2021-05-15,@Lehigh,1,3,Navy,-2
2021-05-15,@Lehigh,10,5,Navy,5
2021-05-16,@Lehigh,5,0,Navy,5
2021-05-26,@Lehigh,7,22,Army,-15
2021-05-27,@Lehigh,3,1,Army,2
2021-05-27,@Lehigh,1,6,Army,-5
2021-02-19,@Campbell,4,1,Campbell,3
2021-02-20,@Campbell,3,17,Campbell,-14
2021-02-21,@Campbell,2,3,Campbell,-1
2021-02-24,@Liberty,16,2,North Carolina A&T,14
2021-02-26,@Texas Christian,1,4,Texas Christian,-3
2021-02-27,@Texas Christian,2,12,Texas Christian,-10
2021-02-27,@Texas Christian,2,9,Texas Christian,-7
2021-03-02,@Liberty,5,1,Radford,4
2021-03-05,@Central Florida,8,3,Central Florida,5
2021-03-05,@Central Florida,2,1,Central Florida,1
2021-03-07,@Central Florida,3,2,Central Florida,1
2021-03-09,@North Carolina,8,7,North Carolina,1
2021-03-12,@Liberty,4,0,North Alabama,4
2021-03-13,@Liberty,7,0,North Alabama,7
2021-03-14,@Liberty,6,0,North Alabama,6
2021-03-16,@Liberty,8,4,North Carolina,4
2021-03-20,@Liberty,3,2,Virginia Commonwealth,1
2021-03-21,@Virginia Commonwealth,6,1,Virginia Commonwealth,5
2021-03-24,@Liberty,10,2,Virginia,8
2021-03-26,@Bellarmine,5,2,Bellarmine,3
2021-03-27,@Bellarmine,5,1,Bellarmine,4
2021-03-27,@Bellarmine,7,8,Bellarmine,-1
2021-03-30,@Duke,4,5,Duke,-1
2021-04-02,@Liberty,9,3,Virginia Commonwealth,6
2021-04-03,@Virginia Commonwealth,2,4,Virginia Commonwealth,-2
2021-04-07,@Liberty,8,4,Wake Forest,4
2021-04-09,@Liberty,4,1,Lipscomb,3
2021-04-10,@Liberty,18,1,Lipscomb,17
2021-04-11,@Liberty,5,4,Lipscomb,1
2021-04-13,@Liberty,8,2,Virginia Tech,6
2021-04-16,@North Alabama,13,5,North Alabama,8
2021-04-17,@North Alabama,15,1,North Alabama,14
2021-04-18,@North Alabama,15,0,North Alabama,15
2021-04-20,@Liberty,0,7,Duke,-7
2021-04-23,@Liberty,7,2,Coastal Carolina,5
2021-04-24,@Liberty,0,2,Coastal Carolina,-2
2021-04-25,@Liberty,6,4,Coastal Carolina,2
2021-04-27,@Virginia,5,6,Virginia,-1
2021-04-30,@Liberty,15,3,Bellarmine,12
2021-05-01,@Liberty,8,7,Bellarmine,1
2021-05-02,@Liberty,9,8,Bellarmine,1
2021-05-07,@Liberty,4,0,Kennesaw State,4
2021-05-08,@Liberty,6,5,Kennesaw State,1
2021-05-09,@Liberty,4,1,Kennesaw State,3
2021-05-14,@Kennesaw State,3,1,Kennesaw State,2
2021-05-15,@Kennesaw State,12,11,Kennesaw State,1
2021-05-16,@Kennesaw State,4,7,Kennesaw State,-3
2021-05-21,@Liberty,5,2,Bellarmine,3
2021-05-22,@Liberty,12,6,Bellarmine,6
2021-05-27,@Liberty,1,2,Jacksonville,-1
2021-05-28,@Liberty,6,0,Kennesaw State,6
2021-05-28,@Liberty,5,2,North Florida,3
2021-05-29,@Jacksonville,3,7,Jacksonville,-4
2021-06-04,@Duke,11,6,Duke,5
2021-06-05,@Liberty,3,9,Tennessee,-6
2021-06-06,@Liberty,15,4,Duke,11
2021-06-06,@Tennessee,1,3,Tennessee,-2
2021-02-22,@Lipscomb,4,2,Murray State,2
2021-02-22,@Lipscomb,8,2,Murray State,6
2021-02-23,@Lipscomb,1,3,Memphis,-2
2021-02-26,@Lipscomb,4,11,Creighton,-7
2021-02-27,@Lipscomb,14,8,Northern Kentucky,6
2021-02-27,@Lipscomb,9,1,Northern Kentucky,8
2021-02-28,@Lipscomb,7,5,Creighton,2
2021-03-12,@Georgia,0,10,Georgia,-10
2021-03-13,@Georgia,0,7,Georgia,-7
2021-03-14,@Georgia,2,3,Georgia,-1
2021-03-16,@Lipscomb,7,9,Auburn,-2
2021-03-19,@Lipscomb,6,5,Kennesaw State,1
2021-03-20,@Lipscomb,2,15,Kennesaw State,-13
2021-03-21,@Lipscomb,14,0,Kennesaw State,14
2021-03-23,@Vanderbilt,3,11,Vanderbilt,-8
2021-03-26,@North Alabama,2,12,North Alabama,-10
2021-03-27,@North Alabama,6,7,North Alabama,-1
2021-03-28,@North Alabama,5,6,North Alabama,-1
2021-03-30,@Lipscomb,14,7,Austin Peay State,7
2021-04-01,@Lipscomb,9,7,Bellarmine,2
2021-04-02,@Lipscomb,5,7,Bellarmine,-2
2021-04-03,@Lipscomb,14,5,Bellarmine,9
2021-04-06,@Belmont,4,5,Belmont,-1
2021-04-06,@Belmont,10,9,Belmont,1
2021-04-09,@Liberty,1,4,Liberty,-3
2021-04-10,@Liberty,1,18,Liberty,-17
2021-04-11,@Liberty,4,5,Liberty,-1
2021-04-13,@Pittsburgh,6,9,Pittsburgh,-3
2021-04-16,@Lipscomb,5,9,Appalachian State,-4
2021-04-17,@Lipscomb,4,2,Appalachian State,2
2021-04-18,@Lipscomb,3,4,Appalachian State,-1
2021-04-21,@Lipscomb,2,11,Belmont,-9
2021-04-23,@Kennesaw State,2,7,Kennesaw State,-5
2021-04-25,@Kennesaw State,8,4,Kennesaw State,4
2021-04-25,@Kennesaw State,0,7,Kennesaw State,-7
2021-04-27,@Tennessee,4,1,Tennessee,3
2021-04-30,@Lipscomb,3,6,North Alabama,-3
2021-05-01,@Lipscomb,3,5,North Alabama,-2
2021-05-02,@Lipscomb,14,5,North Alabama,9
2021-05-07,@Bellarmine,5,3,Bellarmine,2
2021-05-08,@Bellarmine,9,8,Bellarmine,1
2021-05-08,@Bellarmine,4,10,Bellarmine,-6
2021-05-13,@Lipscomb,2,3,Southeast Missouri State,-1
2021-05-14,@Lipscomb,3,0,Southeast Missouri State,3
2021-05-15,@Lipscomb,4,8,Southeast Missouri State,-4
2021-05-21,@Kennesaw State,1,14,Kennesaw State,-13
2021-05-22,@Kennesaw State,2,10,Kennesaw State,-8
2021-03-19,@Hawaii,2,3,Hawaii,-1
2021-03-20,@Hawaii,4,6,Hawaii,-2
2021-03-20,@Hawaii,0,1,Hawaii,-1
2021-03-21,@Hawaii,8,5,Hawaii,3
2021-03-26,@Long Beach State,1,3,Cal State Northridge,-2
2021-03-27,@Long Beach State,10,5,Cal State Northridge,5
2021-03-27,@Long Beach State,7,3,Cal State Northridge,4
2021-03-28,@Long Beach State,1,6,Cal State Northridge,-5
2021-04-01,@UC San Diego,9,5,UC San Diego,4
2021-04-02,@UC San Diego,6,1,UC San Diego,5
2021-04-02,@UC San Diego,10,11,UC San Diego,-1
2021-04-03,@UC San Diego,3,2,UC San Diego,1
2021-04-09,@Long Beach State,7,0,Cal Poly,7
2021-04-10,@Long Beach State,5,7,Cal Poly,-2
2021-04-10,@Long Beach State,2,1,Cal Poly,1
2021-04-11,@Long Beach State,1,5,Cal Poly,-4
2021-04-16,@Pacific,3,2,Pacific,1
2021-04-17,@Pacific,12,17,Pacific,-5
2021-04-18,@Pacific,28,10,Pacific,18
2021-04-23,@Long Beach State,4,3,UC Santa Barbara,1
2021-04-24,@Long Beach State,5,4,UC Santa Barbara,1
2021-04-24,@Long Beach State,0,6,UC Santa Barbara,-6
2021-04-25,@Long Beach State,5,8,UC Santa Barbara,-3
2021-04-30,@UC Irvine,5,12,UC Irvine,-7
2021-05-01,@UC Irvine,13,4,UC Irvine,9
2021-05-01,@UC Irvine,2,3,UC Irvine,-1
2021-05-02,@UC Irvine,9,0,UC Irvine,9
2021-05-07,@UC Riverside,4,0,UC Riverside,4
2021-05-08,@UC Riverside,13,0,UC Riverside,13
2021-05-08,@UC Riverside,10,4,UC Riverside,6
2021-05-09,@UC Riverside,8,7,UC Riverside,1
2021-05-14,@Long Beach State,5,1,CSU Bakersfield,4
2021-05-15,@Long Beach State,5,0,CSU Bakersfield,5
2021-05-15,@Long Beach State,1,2,CSU Bakersfield,-1
2021-05-16,@Long Beach State,3,2,CSU Bakersfield,1
2021-05-21,@Cal State Fullerton,9,1,Cal State Fullerton,8
2021-05-22,@Cal State Fullerton,14,4,Cal State Fullerton,10
2021-05-22,@Cal State Fullerton,3,11,Cal State Fullerton,-8
2021-05-23,@Cal State Fullerton,4,1,Cal State Fullerton,3
2021-05-28,@Long Beach State,7,0,UC Davis,7
2021-05-29,@Long Beach State,7,4,UC Davis,3
2021-05-29,@Long Beach State,7,1,UC Davis,6
2021-05-30,@Long Beach State,10,4,UC Davis,6
2021-02-19,@The Citadel,12,5,The Citadel,7
2021-02-20,@The Citadel,4,2,The Citadel,2
2021-02-21,@The Citadel,6,9,The Citadel,-3
2021-02-23,@Longwood,22,14,North Carolina Central,8
2021-02-26,@Longwood,0,12,Oakland,-12
2021-02-27,@Longwood,3,2,Oakland,1
2021-02-27,@Longwood,1,2,Oakland,-1
2021-02-28,@Longwood,5,10,Oakland,-5
2021-03-05,@Charleston Southern,0,7,Charleston Southern,-7
2021-03-06,@Charleston Southern,10,8,Charleston Southern,2
2021-03-06,@Charleston Southern,5,6,Charleston Southern,-1
2021-03-09,@Norfolk State,7,4,Norfolk State,3
2021-03-14,@Norfolk State,8,5,Norfolk State,3
2021-03-14,@Norfolk State,1,2,Norfolk State,-1
2021-03-16,@High Point,2,9,High Point,-7
2021-03-20,@Longwood,5,6,Winthrop,-1
2021-03-20,@Longwood,7,3,Winthrop,4
2021-03-21,@Longwood,6,14,Winthrop,-8
2021-03-23,@Radford,3,11,Radford,-8
2021-03-27,@Richmond,5,10,Richmond,-5
2021-03-27,@Richmond,4,5,Richmond,-1
2021-04-01,@Gardner-Webb,2,10,Gardner-Webb,-8
2021-04-01,@Gardner-Webb,3,10,Gardner-Webb,-7
2021-04-02,@Gardner-Webb,3,7,Gardner-Webb,-4
2021-04-06,@Longwood,14,6,Norfolk State,8
2021-04-09,@Longwood,2,12,High Point,-10
2021-04-10,@Longwood,3,11,High Point,-8
2021-04-10,@Longwood,8,1,High Point,7
2021-04-16,@Longwood,8,5,Presbyterian,3
2021-04-16,@Longwood,6,7,Presbyterian,-1
2021-04-17,@Longwood,9,10,Presbyterian,-1
2021-04-17,@Longwood,5,6,Presbyterian,-1
2021-04-20,@Longwood,5,16,Radford,-11
2021-04-23,@South Carolina-Upstate,5,13,South Carolina-Upstate,-8
2021-04-23,@South Carolina-Upstate,3,10,South Carolina-Upstate,-7
2021-04-25,@South Carolina-Upstate,3,13,South Carolina-Upstate,-10
2021-04-30,@Longwood,10,7,Radford,3
2021-05-01,@Longwood,7,3,Radford,4
2021-05-01,@Longwood,6,4,Radford,2
2021-05-07,@North Carolina-Asheville,2,3,North Carolina-Asheville,-1
2021-05-07,@North Carolina-Asheville,10,11,North Carolina-Asheville,-1
2021-05-08,@North Carolina-Asheville,5,3,North Carolina-Asheville,2
2021-05-11,@Longwood,8,1,High Point,7
2021-05-14,@Winthrop,16,7,Winthrop,9
2021-05-15,@Winthrop,2,3,Winthrop,-1
2021-05-15,@Winthrop,4,7,Winthrop,-3
2021-05-20,@Longwood,8,10,Charleston Southern,-2
2021-05-20,@Longwood,4,6,Charleston Southern,-2
2021-05-21,@Longwood,2,13,Charleston Southern,-11
2021-02-20,@Louisiana State,6,1,Air Force,5
2021-02-21,@Louisiana State,5,6,Air Force,-1
2021-02-22,@Louisiana State,16,7,Louisiana Tech,9
2021-02-24,@Louisiana-Lafayette,11,2,Louisiana-Lafayette,9
2021-02-26,@Louisiana State,6,2,Youngstown State,4
2021-02-27,@Louisiana State,14,0,Nicholls State,14
2021-02-27,@Louisiana State,5,3,Youngstown State,2
2021-03-03,@Louisiana State,16,1,Southern,15
2021-03-03,@Louisiana State,5,4,Nicholls State,1
2021-03-05,@Louisiana State,7,22,Oral Roberts,-15
2021-03-06,@Louisiana State,12,0,Oral Roberts,12
2021-03-07,@Louisiana State,1,3,Oral Roberts,-2
2021-03-09,@Louisiana State,10,4,Texas Southern,6
2021-03-10,@New Orleans,5,0,New Orleans,5
2021-03-12,@Louisiana State,3,1,Texas-San Antonio,2
2021-03-13,@Louisiana State,10,9,Texas-San Antonio,1
2021-03-14,@Louisiana State,13,12,Texas-San Antonio,1
2021-03-16,@Louisiana State,10,7,Southeastern Louisiana,3
2021-03-19,@Louisiana State,1,6,Mississippi State,-5
2021-03-20,@Louisiana State,0,3,Mississippi State,-3
2021-03-21,@Louisiana State,8,3,Mississippi State,5
2021-03-26,@Tennessee,1,3,Tennessee,-2
2021-03-28,@Tennessee,8,9,Tennessee,-1
2021-03-28,@Tennessee,2,3,Tennessee,-1
2021-03-30,@Louisiana State,11,1,South Alabama,10
2021-04-01,@Louisiana State,1,13,Vanderbilt,-12
2021-04-02,@Louisiana State,2,11,Vanderbilt,-9
2021-04-03,@Louisiana State,4,5,Vanderbilt,-1
2021-04-06,@Louisiana State,14,1,McNeese State,13
2021-04-09,@Kentucky,15,2,Kentucky,13
2021-04-10,@Kentucky,8,6,Kentucky,2
2021-04-11,@Kentucky,4,13,Kentucky,-9
2021-04-15,@Louisiana State,5,1,South Carolina,4
2021-04-17,@Louisiana State,0,9,South Carolina,-9
2021-04-17,@Louisiana State,2,4,South Carolina,-2
2021-04-20,@Louisiana State,5,0,Louisiana-Monroe,5
2021-04-22,@Mississippi,5,4,Mississippi,1
2021-04-23,@Mississippi,7,2,Mississippi,5
2021-04-24,@Mississippi,9,10,Mississippi,-1
2021-04-27,@Louisiana State,7,0,Grambling State,7
2021-04-30,@Louisiana State,0,7,Arkansas,-7
2021-05-01,@Louisiana State,10,17,Arkansas,-7
2021-05-01,@Louisiana State,5,4,Arkansas,1
2021-05-03,@Louisiana State,10,2,Southern,8
2021-05-06,@Auburn,8,3,Auburn,5
2021-05-07,@Auburn,9,6,Auburn,3
2021-05-08,@Auburn,1,2,Auburn,-1
2021-05-11,@Louisiana State,16,8,Louisiana Tech,8
2021-05-14,@Louisiana State,2,1,Alabama,1
2021-05-15,@Louisiana State,5,6,Alabama,-1
2021-05-16,@Louisiana State,13,5,Alabama,8
2021-05-18,@Louisiana State,3,7,Northwestern State,-4
2021-05-20,@Texas A&M,1,2,Texas A&M,-1
2021-05-21,@Texas A&M,12,6,Texas A&M,6
2021-05-22,@Texas A&M,8,2,Texas A&M,6
2021-05-25,@Georgia,1,4,Georgia,-3
2021-06-04,@Gonzaga,0,3,Gonzaga,-3
2021-06-05,@Louisiana State,6,5,Central Connecticut State,1
2021-06-06,@Louisiana State,9,4,Gonzaga,5
2021-06-06,@Oregon,4,1,Oregon,3
2021-06-07,@Louisiana State,9,8,Oregon,1
2021-06-12,@Tennessee,2,4,Tennessee,-2
2021-06-13,@Louisiana State,6,15,Tennessee,-9
2021-02-21,@Air Force,18,1,Air Force,17
2021-02-22,@Louisiana State,7,16,Louisiana State,-9
2021-02-23,@Louisiana-Lafayette,0,2,Louisiana-Lafayette,-2
2021-02-26,@Louisiana Tech,9,2,Southern,7
2021-02-27,@Louisiana Tech,5,1,Southern,4
2021-02-28,@Louisiana Tech,12,4,Southern,8
2021-03-02,@Louisiana-Lafayette,2,7,Louisiana-Lafayette,-5
2021-03-05,@Louisiana Tech,11,0,McNeese State,11
2021-03-06,@Louisiana Tech,4,3,McNeese State,1
2021-03-07,@Louisiana Tech,14,4,McNeese State,10
2021-03-09,@Louisiana-Monroe,10,3,Louisiana-Monroe,7
2021-03-12,@Louisiana Tech,7,9,Arkansas,-2
2021-03-13,@Louisiana Tech,1,8,Arkansas,-7
2021-03-14,@Louisiana Tech,2,0,Arkansas,2
2021-03-16,@Louisiana Tech,13,1,Mississippi,12
2021-03-19,@Tulane,2,0,Tulane,2
2021-03-20,@Tulane,4,0,Tulane,4
2021-03-21,@Tulane,8,6,Tulane,2
2021-03-23,@Louisiana Tech,9,7,Louisiana-Monroe,2
2021-03-26,@Southern Mississippi,3,2,Southern Mississippi,1
2021-03-27,@Southern Mississippi,4,0,Southern Mississippi,4
2021-03-27,@Southern Mississippi,6,14,Southern Mississippi,-8
2021-03-28,@Southern Mississippi,8,7,Southern Mississippi,1
2021-04-01,@Louisiana Tech,16,1,Alabama-Birmingham,15
2021-04-02,@Louisiana Tech,6,4,Alabama-Birmingham,2
2021-04-02,@Louisiana Tech,3,9,Alabama-Birmingham,-6
2021-04-03,@Louisiana Tech,6,0,Alabama-Birmingham,6
2021-04-09,@Rice,6,0,Rice,6
2021-04-10,@Rice,7,6,Rice,1
2021-04-10,@Rice,20,6,Rice,14
2021-04-11,@Rice,13,4,Rice,9
2021-04-17,@Louisiana Tech,3,4,Southern Mississippi,-1
2021-04-17,@Louisiana Tech,5,3,Southern Mississippi,2
2021-04-18,@Louisiana Tech,11,12,Southern Mississippi,-1
2021-04-18,@Louisiana Tech,7,6,Southern Mississippi,1
2021-04-23,@Louisiana Tech,4,3,Marshall,1
2021-04-24,@Louisiana Tech,11,4,Marshall,7
2021-04-24,@Louisiana Tech,5,11,Marshall,-6
2021-04-25,@Louisiana Tech,2,7,Marshall,-5
2021-04-30,@Middle Tennessee State,9,7,Middle Tennessee State,2
2021-05-01,@Middle Tennessee State,5,4,Middle Tennessee State,1
2021-05-01,@Middle Tennessee State,1,0,Middle Tennessee State,1
2021-05-02,@Middle Tennessee State,6,1,Middle Tennessee State,5
2021-05-08,@Florida International,12,7,Florida International,5
2021-05-08,@Florida International,5,10,Florida International,-5
2021-05-11,@Louisiana State,8,16,Louisiana State,-8
2021-05-14,@Louisiana Tech,5,7,Texas-San Antonio,-2
2021-05-15,@Louisiana Tech,4,1,Texas-San Antonio,3
2021-05-15,@Louisiana Tech,10,7,Texas-San Antonio,3
2021-05-16,@Louisiana Tech,17,7,Texas-San Antonio,10
2021-05-20,@Louisiana Tech,8,10,Old Dominion,-2
2021-05-21,@Louisiana Tech,7,8,Old Dominion,-1
2021-05-26,@Louisiana Tech,7,6,Texas-San Antonio,1
2021-05-27,@Louisiana Tech,1,4,Southern Mississippi,-3
2021-05-28,@Louisiana Tech,14,4,Western Kentucky,10
2021-05-29,@Louisiana Tech,6,5,Southern Mississippi,1
2021-05-29,@Louisiana Tech,11,10,Southern Mississippi,1
2021-05-30,@Louisiana Tech,5,7,Old Dominion,-2
2021-06-04,@Louisiana Tech,18,2,Rider,16
2021-06-05,@Louisiana Tech,3,8,North Carolina State,-5
2021-06-06,@Alabama,10,8,Alabama,2
2021-06-06,@North Carolina State,7,14,North Carolina State,-7
2021-02-24,@Louisiana-Monroe,5,2,Northwestern State,3
2021-02-26,@New Orleans,6,7,New Orleans,-1
2021-02-27,@New Orleans,4,7,New Orleans,-3
2021-02-28,@New Orleans,7,2,New Orleans,5
2021-03-03,@Louisiana-Monroe,9,1,Grambling State,8
2021-03-06,@Louisiana-Monroe,5,3,Nicholls State,2
2021-03-06,@Louisiana-Monroe,2,5,Nicholls State,-3
2021-03-07,@Louisiana-Monroe,6,4,Nicholls State,2
2021-03-09,@Louisiana-Monroe,3,10,Louisiana Tech,-7
2021-03-12,@Mississippi,1,10,Mississippi,-9
2021-03-13,@Mississippi,5,6,Mississippi,-1
2021-03-14,@Mississippi,8,3,Mississippi,5
2021-03-16,@Oklahoma State,13,6,Oklahoma State,7
2021-03-19,@Louisiana-Monroe,3,4,Georgia State,-1
2021-03-20,@Louisiana-Monroe,3,1,Georgia State,2
2021-03-21,@Louisiana-Monroe,9,7,Georgia State,2
2021-03-23,@Louisiana Tech,7,9,Louisiana Tech,-2
2021-03-26,@Texas State,6,5,Texas State,1
2021-03-27,@Texas State,5,6,Texas State,-1
2021-03-28,@Texas State,1,4,Texas State,-3
2021-03-30,@Grambling State,3,15,Grambling State,-12
2021-04-01,@Louisiana-Monroe,5,9,Louisiana-Lafayette,-4
2021-04-02,@Louisiana-Monroe,2,5,Louisiana-Lafayette,-3
2021-04-03,@Louisiana-Monroe,9,11,Louisiana-Lafayette,-2
2021-04-07,@Alabama,5,3,Alabama,2
2021-04-09,@Georgia Southern,3,4,Georgia Southern,-1
2021-04-10,@Georgia Southern,1,4,Georgia Southern,-3
2021-04-11,@Georgia Southern,1,7,Georgia Southern,-6
2021-04-17,@Louisiana-Monroe,0,2,Arkansas-Little Rock,-2
2021-04-18,@Louisiana-Monroe,5,3,Arkansas-Little Rock,2
2021-04-19,@Louisiana-Monroe,5,4,Arkansas-Little Rock,1
2021-04-20,@Louisiana State,0,5,Louisiana State,-5
2021-04-21,@Louisiana-Monroe,18,6,Jackson State,12
2021-04-23,@Louisiana-Monroe,12,1,Southern,11
2021-04-25,@Louisiana-Monroe,2,0,Southern,2
2021-04-25,@Louisiana-Monroe,11,1,Southern,10
2021-04-27,@Louisiana-Lafayette,7,6,Louisiana-Lafayette,1
2021-04-30,@Appalachian State,4,6,Appalachian State,-2
2021-05-01,@Appalachian State,10,7,Appalachian State,3
2021-05-02,@Appalachian State,13,5,Appalachian State,8
2021-05-05,@Jackson State,2,4,Jackson State,-2
2021-05-07,@Louisiana-Monroe,1,6,Texas-Arlington,-5
2021-05-08,@Louisiana-Monroe,5,1,Texas-Arlington,4
2021-05-08,@Louisiana-Monroe,10,8,Texas-Arlington,2
2021-05-14,@Texas Christian,4,3,Texas Christian,1
2021-05-15,@Texas Christian,4,6,Texas Christian,-2
2021-05-15,@Texas Christian,13,9,Texas Christian,4
2021-05-20,@Arkansas State,6,12,Arkansas State,-6
2021-05-21,@Arkansas State,10,7,Arkansas State,3
2021-05-22,@Arkansas State,6,4,Arkansas State,2
2021-05-25,@Louisiana-Monroe,6,9,Georgia State,-3
2021-05-28,@Georgia Southern,5,9,Georgia Southern,-4
2021-02-20,@Louisville,5,1,Bellarmine,4
2021-02-21,@Louisville,13,1,Bellarmine,12
2021-02-21,@Louisville,8,3,Bellarmine,5
2021-02-23,@Louisville,6,2,Eastern Kentucky,4
2021-02-26,@Louisville,3,8,Western Illinois,-5
2021-02-27,@Louisville,9,4,Western Illinois,5
2021-02-27,@Louisville,4,1,Western Illinois,3
2021-03-02,@Louisville,2,5,Morehead State,-3
2021-03-05,@Georgia Tech,13,6,Georgia Tech,7
2021-03-06,@Georgia Tech,6,19,Georgia Tech,-13
2021-03-07,@Georgia Tech,9,13,Georgia Tech,-4
2021-03-09,@Louisville,8,3,Murray State,5
2021-03-12,@Louisville,7,3,Boston College,4
2021-03-13,@Louisville,5,0,Boston College,5
2021-03-14,@Louisville,8,6,Boston College,2
2021-03-16,@Eastern Kentucky,3,6,Eastern Kentucky,-3
2021-03-19,@North Carolina State,13,1,North Carolina State,12
2021-03-20,@North Carolina State,6,3,North Carolina State,3
2021-03-21,@North Carolina State,8,3,North Carolina State,5
2021-03-23,@Louisville,13,6,Western Kentucky,7
2021-03-26,@Notre Dame,7,4,Notre Dame,3
2021-03-27,@Notre Dame,3,5,Notre Dame,-2
2021-03-30,@Cincinnati,12,13,Cincinnati,-1
2021-04-02,@Louisville,5,3,Wake Forest,2
2021-04-03,@Louisville,9,7,Wake Forest,2
2021-04-04,@Louisville,3,6,Wake Forest,-3
2021-04-06,@Louisville,7,11,Kentucky,-4
2021-04-09,@Louisville,4,3,Florida State,1
2021-04-10,@Louisville,5,8,Florida State,-3
2021-04-11,@Louisville,11,4,Florida State,7
2021-04-16,@Virginia,7,8,Virginia,-1
2021-04-17,@Virginia,9,5,Virginia,4
2021-04-18,@Virginia,8,2,Virginia,6
2021-04-20,@Kentucky,12,5,Kentucky,7
2021-04-30,@Clemson,3,11,Clemson,-8
2021-05-01,@Clemson,4,5,Clemson,-1
2021-05-02,@Clemson,5,15,Clemson,-10
2021-05-04,@Louisville,7,2,Vanderbilt,5
2021-05-07,@Louisville,3,13,Duke,-10
2021-05-08,@Louisville,15,6,Duke,9
2021-05-08,@Louisville,5,1,Duke,4
2021-05-14,@North Carolina,1,5,North Carolina,-4
2021-05-15,@North Carolina,0,5,North Carolina,-5
2021-05-16,@North Carolina,5,10,North Carolina,-5
2021-05-18,@Louisville,8,6,South Carolina-Upstate,2
2021-05-20,@Louisville,1,6,"Miami, Florida",-5
2021-05-21,@Louisville,0,2,"Miami, Florida",-2
2021-05-22,@Louisville,2,3,"Miami, Florida",-1
2021-05-25,@Louisville,15,10,Clemson,5
2021-05-27,@Georgia Tech,8,9,Georgia Tech,-1
2021-02-19,@Southern California,2,3,Southern California,-1
2021-02-20,@Southern California,0,5,Southern California,-5
2021-02-21,@Loyola Marymount,9,8,Southern California,1
2021-02-23,@UCLA,2,5,UCLA,-3
2021-02-26,@Loyola Marymount,7,6,Utah,1
2021-02-27,@Loyola Marymount,9,7,Utah,2
2021-02-28,@Loyola Marymount,4,1,Utah,3
2021-03-05,@Washington,2,1,Washington,1
2021-03-06,@Washington,2,7,Washington,-5
2021-03-07,@Washington,3,2,Washington,1
2021-03-12,@California,4,3,California,1
2021-03-13,@California,4,6,California,-2
2021-03-13,@California,5,11,California,-6
2021-03-14,@California,1,7,California,-6
2021-03-18,@Loyola Marymount,4,5,Brigham Young,-1
2021-03-19,@Loyola Marymount,2,9,Brigham Young,-7
2021-03-20,@Loyola Marymount,1,4,Brigham Young,-3
2021-03-22,@Loyola Marymount,2,18,Arizona,-16
2021-03-23,@UCLA,6,13,UCLA,-7
2021-03-26,@Loyola Marymount,7,1,Gonzaga,6
2021-03-27,@Loyola Marymount,8,4,Gonzaga,4
2021-03-28,@Loyola Marymount,2,14,Gonzaga,-12
2021-03-30,@Loyola Marymount,3,4,Southern California,-1
2021-04-01,@San Francisco,3,4,San Francisco,-1
2021-04-02,@San Francisco,6,8,San Francisco,-2
2021-04-03,@San Francisco,4,9,San Francisco,-5
2021-04-09,@Loyola Marymount,9,5,San Diego,4
2021-04-10,@Loyola Marymount,0,6,San Diego,-6
2021-04-11,@Loyola Marymount,4,2,San Diego,2
2021-04-13,@UCLA,2,12,UCLA,-10
2021-04-16,@Portland,8,5,Portland,3
2021-04-17,@Portland,1,9,Portland,-8
2021-04-18,@Portland,2,8,Portland,-6
2021-04-20,@Southern California,1,8,Southern California,-7
2021-04-23,@Pepperdine,4,1,Pepperdine,3
2021-04-24,@Pepperdine,5,4,Pepperdine,1
2021-04-25,@Pepperdine,4,18,Pepperdine,-14
2021-04-27,@Loyola Marymount,2,8,Oregon State,-6
2021-04-28,@Loyola Marymount,5,8,Oregon State,-3
2021-04-30,@Loyola Marymount,5,2,Santa Clara,3
2021-05-01,@Loyola Marymount,3,1,Santa Clara,2
2021-05-02,@Loyola Marymount,7,11,Santa Clara,-4
2021-05-11,@Loyola Marymount,8,9,UCLA,-1
2021-05-14,@St. Mary's,9,7,St. Mary's,2
2021-05-15,@St. Mary's,6,4,St. Mary's,2
2021-05-16,@St. Mary's,0,1,St. Mary's,-1
2021-05-21,@Loyola Marymount,7,2,Pacific,5
2021-05-22,@Loyola Marymount,2,3,Pacific,-1
2021-05-23,@Loyola Marymount,10,3,Pacific,7
2021-03-06,@Merrimack,4,1,Merrimack,3
2021-03-06,@Merrimack,9,2,Merrimack,7
2021-03-07,@Merrimack,14,9,Merrimack,5
2021-03-07,@Merrimack,0,5,Merrimack,-5
2021-03-09,@Boston College,5,10,Boston College,-5
2021-03-13,@Wagner,5,1,Wagner,4
2021-03-13,@Wagner,2,6,Wagner,-4
2021-03-14,@Wagner,12,3,Wagner,9
2021-03-27,@Maine,10,2,Maryland-Baltimore County,8
2021-03-27,@Maine,4,1,Maryland-Baltimore County,3
2021-03-28,@Maine,1,7,Maryland-Baltimore County,-6
2021-04-02,@Maine,2,0,Binghamton,2
2021-04-02,@Maine,3,8,Binghamton,-5
2021-04-03,@Maine,2,3,Binghamton,-1
2021-04-03,@Maine,0,5,Binghamton,-5
2021-04-09,@New Jersey Tech,9,10,New Jersey Tech,-1
2021-04-09,@New Jersey Tech,8,2,New Jersey Tech,6
2021-04-10,@New Jersey Tech,14,2,New Jersey Tech,12
2021-04-10,@New Jersey Tech,10,1,New Jersey Tech,9
2021-04-17,@Maine,0,7,Hartford,-7
2021-04-17,@Maine,11,0,Hartford,11
2021-04-23,@Massachusetts-Lowell,1,5,Massachusetts-Lowell,-4
2021-04-23,@Massachusetts-Lowell,11,7,Massachusetts-Lowell,4
2021-04-24,@Massachusetts-Lowell,4,9,Massachusetts-Lowell,-5
2021-04-24,@Massachusetts-Lowell,1,2,Massachusetts-Lowell,-1
2021-05-01,@Albany,14,2,Albany,12
2021-05-01,@Albany,7,6,Albany,1
2021-05-02,@Albany,11,23,Albany,-12
2021-05-02,@Albany,3,4,Albany,-1
2021-05-08,@Maine,4,6,Massachusetts-Lowell,-2
2021-05-08,@Maine,3,2,Massachusetts-Lowell,1
2021-05-09,@Maine,0,1,Massachusetts-Lowell,-1
2021-05-09,@Maine,3,10,Massachusetts-Lowell,-7
2021-05-14,@Hartford,5,6,Hartford,-1
2021-05-15,@Hartford,6,2,Hartford,4
2021-05-15,@Hartford,15,0,Hartford,15
2021-05-16,@Hartford,16,6,Hartford,10
2021-05-21,@Maine,0,3,Albany,-3
2021-05-21,@Maine,3,9,Albany,-6
2021-05-22,@Maine,4,2,Albany,2
2021-05-22,@Maine,6,5,Albany,1
2021-05-27,@Stony Brook,4,2,Stony Brook,2
2021-05-28,@New Jersey Tech,1,2,New Jersey Tech,-1
2021-05-29,@Stony Brook,9,15,Stony Brook,-6
2021-03-28,@Monmouth,0,2,Monmouth,-2
2021-03-29,@Monmouth,1,3,Monmouth,-2
2021-03-29,@Monmouth,1,3,Monmouth,-2
2021-03-29,@Monmouth,0,10,Monmouth,-10
2021-04-02,@Manhattan,8,1,Rider,7
2021-04-02,@Manhattan,2,10,Rider,-8
2021-04-03,@Manhattan,3,9,Rider,-6
2021-04-03,@Manhattan,1,6,Rider,-5
2021-04-07,@Manhattan,8,1,Iona,7
2021-04-07,@Manhattan,13,1,Iona,12
2021-04-10,@Canisius,2,7,Canisius,-5
2021-04-10,@Canisius,3,10,Canisius,-7
2021-04-11,@Canisius,2,13,Canisius,-11
2021-04-11,@Canisius,2,4,Canisius,-2
2021-04-17,@Siena,4,12,Siena,-8
2021-04-17,@Siena,11,0,Siena,11
2021-04-18,@Siena,7,4,Siena,3
2021-04-18,@Siena,13,11,Siena,2
2021-04-23,@Manhattan,4,12,Fairfield,-8
2021-04-23,@Manhattan,4,16,Fairfield,-12
2021-04-24,@Manhattan,4,8,Fairfield,-4
2021-04-24,@Manhattan,9,19,Fairfield,-10
2021-05-01,@Manhattan,6,10,Niagara,-4
2021-05-01,@Manhattan,5,4,Niagara,1
2021-05-02,@Manhattan,15,8,Niagara,7
2021-05-02,@Manhattan,5,8,Niagara,-3
2021-05-08,@Marist,5,6,Marist,-1
2021-05-08,@Marist,8,6,Marist,2
2021-05-09,@Marist,2,7,Marist,-5
2021-05-09,@Marist,5,7,Marist,-2
2021-05-15,@Manhattan,4,3,St. Peter's,1
2021-05-15,@Manhattan,12,1,St. Peter's,11
2021-05-16,@Manhattan,5,4,St. Peter's,1
2021-05-16,@Manhattan,7,8,St. Peter's,-1
2021-05-20,@Fairfield,1,2,Fairfield,-1
2021-05-20,@Fairfield,1,2,Fairfield,-1
2021-04-17,@St. Peter's,7,2,St. Peter's,5
2021-04-17,@St. Peter's,0,3,St. Peter's,-3
2021-04-18,@St. Peter's,13,3,St. Peter's,10
2021-04-18,@St. Peter's,9,1,St. Peter's,8
2021-04-20,@Marist,16,1,Siena,15
2021-04-20,@Marist,16,3,Siena,13
2021-04-23,@Marist,5,8,Niagara,-3
2021-04-23,@Marist,6,3,Niagara,3
2021-04-24,@Marist,6,7,Niagara,-1
2021-04-24,@Marist,14,3,Niagara,11
2021-04-28,@Rider,10,3,Rider,7
2021-04-28,@Rider,8,5,Rider,3
2021-05-01,@Monmouth,2,5,Monmouth,-3
2021-05-01,@Monmouth,1,4,Monmouth,-3
2021-05-02,@Monmouth,0,8,Monmouth,-8
2021-05-02,@Monmouth,2,1,Monmouth,1
2021-05-08,@Marist,6,5,Manhattan,1
2021-05-08,@Marist,6,8,Manhattan,-2
2021-05-09,@Marist,7,2,Manhattan,5
2021-05-09,@Marist,7,5,Manhattan,2
2021-05-12,@Marist,13,6,Siena,7
2021-05-12,@Marist,10,2,Siena,8
2021-05-14,@Quinnipiac,12,4,Quinnipiac,8
2021-05-14,@Quinnipiac,1,5,Quinnipiac,-4
2021-05-15,@Marist,9,4,Quinnipiac,5
2021-05-15,@Marist,9,11,Quinnipiac,-2
2021-05-20,@Canisius,3,8,Canisius,-5
2021-05-20,@Canisius,12,6,Canisius,6
2021-05-21,@Canisius,7,10,Canisius,-3
2021-03-05,@Marshall,3,1,Morehead State,2
2021-03-06,@Morehead State,10,13,Morehead State,-3
2021-03-07,@Marshall,2,6,Morehead State,-4
2021-03-09,@Eastern Kentucky,1,2,Eastern Kentucky,-1
2021-03-12,@Mercer,1,3,Mercer,-2
2021-03-13,@Mercer,11,10,Mercer,1
2021-03-14,@Mercer,19,9,Mercer,10
2021-03-19,@Southern Illinois,4,10,Southern Illinois,-6
2021-03-20,@Southern Illinois,2,7,Southern Illinois,-5
2021-03-21,@Southern Illinois,0,2,Southern Illinois,-2
2021-03-23,@Marshall,7,1,West Virginia,6
2021-03-26,@Florida Atlantic,0,12,Florida Atlantic,-12
2021-03-27,@Florida Atlantic,6,7,Florida Atlantic,-1
2021-03-27,@Florida Atlantic,3,5,Florida Atlantic,-2
2021-03-28,@Florida Atlantic,2,11,Florida Atlantic,-9
2021-04-02,@Marshall,1,12,Old Dominion,-11
2021-04-03,@Marshall,7,8,Old Dominion,-1
2021-04-03,@Marshall,0,8,Old Dominion,-8
2021-04-04,@Marshall,7,15,Old Dominion,-8
2021-04-09,@Western Kentucky,1,5,Western Kentucky,-4
2021-04-09,@Western Kentucky,0,1,Western Kentucky,-1
2021-04-10,@Western Kentucky,2,5,Western Kentucky,-3
2021-04-11,@Western Kentucky,1,8,Western Kentucky,-7
2021-04-14,@West Virginia,3,9,West Virginia,-6
2021-04-16,@Marshall,2,8,Florida International,-6
2021-04-17,@Marshall,0,5,Florida International,-5
2021-04-17,@Marshall,6,1,Florida International,5
2021-04-18,@Marshall,10,8,Florida International,2
2021-04-23,@Louisiana Tech,3,4,Louisiana Tech,-1
2021-04-24,@Louisiana Tech,11,5,Louisiana Tech,6
2021-04-24,@Louisiana Tech,4,11,Louisiana Tech,-7
2021-04-25,@Louisiana Tech,7,2,Louisiana Tech,5
2021-04-30,@Marshall,6,10,Western Kentucky,-4
2021-05-01,@Marshall,5,15,Western Kentucky,-10
2021-05-01,@Marshall,1,6,Western Kentucky,-5
2021-05-02,@Marshall,6,10,Western Kentucky,-4
2021-05-07,@North Carolina-Charlotte,5,7,North Carolina-Charlotte,-2
2021-05-08,@North Carolina-Charlotte,8,10,North Carolina-Charlotte,-2
2021-05-08,@North Carolina-Charlotte,3,12,North Carolina-Charlotte,-9
2021-05-09,@North Carolina-Charlotte,3,6,North Carolina-Charlotte,-3
2021-05-11,@West Virginia,1,4,West Virginia,-3
2021-05-14,@Marshall,8,6,Alabama-Birmingham,2
2021-05-15,@Marshall,0,6,Alabama-Birmingham,-6
2021-05-15,@Marshall,0,9,Alabama-Birmingham,-9
2021-05-16,@Marshall,7,5,Alabama-Birmingham,2
2021-03-05,@Michigan State,0,6,Michigan State,-6
2021-03-06,@Michigan State,4,7,Michigan State,-3
2021-03-06,@Michigan State,4,5,Michigan State,-1
2021-03-07,@Michigan State,3,2,Michigan State,1
2021-03-12,@Maryland,13,8,Rutgers,5
2021-03-13,@Maryland,3,9,Rutgers,-6
2021-03-13,@Maryland,7,8,Rutgers,-1
2021-03-14,@Maryland,9,5,Rutgers,4
2021-03-20,@Penn State,19,10,Penn State,9
2021-03-21,@Penn State,5,6,Penn State,-1
2021-03-22,@Penn State,7,1,Penn State,6
2021-03-27,@Maryland,4,6,Iowa,-2
2021-03-28,@Iowa,2,11,Iowa,-9
2021-03-28,@Ohio State,4,5,Ohio State,-1
2021-03-29,@Ohio State,9,3,Ohio State,6
2021-04-02,@Maryland,4,3,Northwestern,1
2021-04-03,@Maryland,8,4,Northwestern,4
2021-04-04,@Maryland,5,6,Michigan,-1
2021-04-05,@Maryland,17,7,Michigan,10
2021-04-09,@Nebraska,2,6,Nebraska,-4
2021-04-10,@Nebraska,10,7,Nebraska,3
2021-04-11,@Nebraska,3,14,Nebraska,-11
2021-04-16,@Maryland,10,6,Ohio State,4
2021-04-17,@Maryland,5,4,Ohio State,1
2021-04-18,@Maryland,9,4,Ohio State,5
2021-04-23,@Iowa,2,6,Iowa,-4
2021-04-24,@Iowa,8,6,Iowa,2
2021-04-24,@Northwestern,2,1,Northwestern,1
2021-04-25,@Maryland,9,7,Northwestern,2
2021-04-30,@Maryland,12,4,Minnesota,8
2021-05-01,@Maryland,4,3,Minnesota,1
2021-05-02,@Maryland,6,3,Minnesota,3
2021-05-07,@Illinois,0,2,Illinois,-2
2021-05-08,@Illinois,5,3,Illinois,2
2021-05-08,@Illinois,12,4,Illinois,8
2021-05-14,@Maryland,11,0,Purdue,11
2021-05-15,@Maryland,6,1,Purdue,5
2021-05-16,@Maryland,7,2,Purdue,5
2021-05-21,@Michigan,11,8,Michigan,3
2021-05-22,@Michigan,3,14,Michigan,-11
2021-05-23,@Michigan,7,3,Michigan,4
2021-05-29,@Maryland,5,2,Indiana,3
2021-05-29,@Maryland,4,3,Indiana,1
2021-05-30,@Maryland,3,7,Indiana,-4
2021-06-04,@North Carolina-Charlotte,10,13,North Carolina-Charlotte,-3
2021-06-05,@Norfolk State,16,0,Norfolk State,16
2021-06-06,@Maryland,2,1,North Carolina-Charlotte,1
2021-06-06,@Maryland,6,9,East Carolina,-3
2021-03-06,@Maryland-Baltimore County,20,8,Delaware State,12
2021-03-07,@Maryland-Baltimore County,14,6,Delaware State,8
2021-03-07,@Maryland-Baltimore County,18,2,Delaware State,16
2021-03-12,@George Mason,14,10,George Mason,4
2021-03-14,@Maryland-Baltimore County,13,7,George Mason,6
2021-03-20,@Maryland-Baltimore County,3,2,Massachusetts-Lowell,1
2021-03-20,@Maryland-Baltimore County,14,21,Massachusetts-Lowell,-7
2021-03-21,@Maryland-Baltimore County,4,6,Massachusetts-Lowell,-2
2021-03-21,@Maryland-Baltimore County,7,13,Massachusetts-Lowell,-6
2021-03-27,@Maine,2,10,Maine,-8
2021-03-27,@Maine,1,4,Maine,-3
2021-03-28,@Maine,7,1,Maine,6
2021-04-03,@Albany,0,6,Albany,-6
2021-04-03,@Albany,1,5,Albany,-4
2021-04-04,@Albany,7,4,Albany,3
2021-04-04,@Albany,11,6,Albany,5
2021-04-10,@Maryland-Baltimore County,3,10,Hartford,-7
2021-04-10,@Maryland-Baltimore County,8,5,Hartford,3
2021-04-11,@Maryland-Baltimore County,14,6,Hartford,8
2021-04-11,@Maryland-Baltimore County,13,7,Hartford,6
2021-04-17,@Stony Brook,2,3,Stony Brook,-1
2021-04-17,@Stony Brook,4,6,Stony Brook,-2
2021-04-18,@Stony Brook,5,7,Stony Brook,-2
2021-04-18,@Stony Brook,7,8,Stony Brook,-1
2021-04-23,@Maryland-Baltimore County,15,9,Binghamton,6
2021-04-23,@Maryland-Baltimore County,3,8,Binghamton,-5
2021-04-24,@Maryland-Baltimore County,14,9,Binghamton,5
2021-04-24,@Maryland-Baltimore County,4,6,Binghamton,-2
2021-05-01,@Maryland-Baltimore County,4,17,New Jersey Tech,-13
2021-05-01,@Maryland-Baltimore County,7,10,New Jersey Tech,-3
2021-05-02,@Maryland-Baltimore County,6,14,New Jersey Tech,-8
2021-05-02,@Maryland-Baltimore County,5,7,New Jersey Tech,-2
2021-05-08,@Binghamton,2,3,Binghamton,-1
2021-05-08,@Binghamton,0,9,Binghamton,-9
2021-05-09,@Binghamton,8,3,Binghamton,5
2021-05-09,@Binghamton,1,0,Binghamton,1
2021-05-15,@Maryland-Baltimore County,1,13,Stony Brook,-12
2021-05-15,@Maryland-Baltimore County,8,7,Stony Brook,1
2021-05-16,@Maryland-Baltimore County,0,6,Stony Brook,-6
2021-05-21,@New Jersey Tech,2,3,New Jersey Tech,-1
2021-05-21,@New Jersey Tech,1,7,New Jersey Tech,-6
2021-05-22,@New Jersey Tech,6,13,New Jersey Tech,-7
2021-05-22,@New Jersey Tech,1,8,New Jersey Tech,-7
2021-03-03,@Northeastern,2,11,Northeastern,-9
2021-03-07,@Stony Brook,3,1,Stony Brook,2
2021-03-07,@Stony Brook,9,4,Stony Brook,5
2021-03-09,@Central Connecticut State,6,8,Central Connecticut State,-2
2021-03-12,@Merrimack,6,4,Merrimack,2
2021-03-13,@Merrimack,11,4,Merrimack,7
2021-03-14,@Merrimack,1,3,Merrimack,-2
2021-03-20,@Towson,7,8,Towson,-1
2021-03-20,@Towson,0,4,Towson,-4
2021-03-21,@Towson,10,1,Towson,9
2021-03-21,@Towson,3,1,Towson,2
2021-03-24,@Holy Cross,6,2,Holy Cross,4
2021-03-26,@Northeastern,1,18,Northeastern,-17
2021-03-27,@Northeastern,2,5,Northeastern,-3
2021-03-27,@Northeastern,3,4,Northeastern,-1
2021-03-31,@Massachusetts,6,7,Holy Cross,-1
2021-04-02,@Connecticut,2,9,Connecticut,-7
2021-04-03,@Connecticut,3,7,Connecticut,-4
2021-04-03,@Connecticut,1,11,Connecticut,-10
2021-04-07,@Massachusetts,1,11,Northeastern,-10
2021-04-09,@St. Joseph's,5,7,St. Joseph's,-2
2021-04-09,@St. Joseph's,1,5,St. Joseph's,-4
2021-04-10,@St. Joseph's,2,10,St. Joseph's,-8
2021-04-10,@St. Joseph's,1,6,St. Joseph's,-5
2021-04-14,@Massachusetts,9,8,Merrimack,1
2021-04-17,@Massachusetts,0,3,LaSalle,-3
2021-04-17,@Massachusetts,5,8,LaSalle,-3
2021-04-18,@Massachusetts,6,11,LaSalle,-5
2021-04-18,@Massachusetts,3,4,LaSalle,-1
2021-04-23,@Rhode Island,7,8,Rhode Island,-1
2021-04-23,@Rhode Island,11,2,Rhode Island,9
2021-04-24,@Rhode Island,3,7,Rhode Island,-4
2021-04-24,@Rhode Island,8,10,Rhode Island,-2
2021-04-27,@Sacred Heart,8,6,Sacred Heart,2
2021-04-30,@Fordham,4,2,Fordham,2
2021-05-01,@Fordham,3,5,Fordham,-2
2021-05-01,@Fordham,8,3,Fordham,5
2021-05-02,@Fordham,1,11,Fordham,-10
2021-05-04,@Massachusetts,3,2,Boston College,1
2021-05-20,@Massachusetts,6,17,Rhode Island,-11
2021-05-21,@Massachusetts,5,7,Rhode Island,-2
2021-05-21,@Massachusetts,2,7,Rhode Island,-5
2021-05-22,@Massachusetts,1,16,Rhode Island,-15
2021-02-26,@St. John's,1,2,St. John's,-1
2021-02-27,@St. John's,3,11,St. John's,-8
2021-02-28,@St. John's,1,3,St. John's,-2
2021-03-06,@Rhode Island,1,3,Rhode Island,-2
2021-03-07,@Rhode Island,0,4,Rhode Island,-4
2021-03-07,@Rhode Island,2,5,Rhode Island,-3
2021-03-12,@Northeastern,0,2,Northeastern,-2
2021-03-12,@Northeastern,10,7,Northeastern,3
2021-03-13,@Northeastern,1,2,Northeastern,-1
2021-03-20,@Maryland-Baltimore County,2,3,Maryland-Baltimore County,-1
2021-03-20,@Maryland-Baltimore County,21,14,Maryland-Baltimore County,7
2021-03-21,@Maryland-Baltimore County,13,7,Maryland-Baltimore County,6
2021-03-21,@Maryland-Baltimore County,6,4,Maryland-Baltimore County,2
2021-03-27,@Binghamton,2,3,Binghamton,-1
2021-03-27,@Binghamton,14,1,Binghamton,13
2021-04-02,@Massachusetts-Lowell,8,1,New Jersey Tech,7
2021-04-02,@Massachusetts-Lowell,4,17,New Jersey Tech,-13
2021-04-03,@Massachusetts-Lowell,3,7,New Jersey Tech,-4
2021-04-03,@Massachusetts-Lowell,5,9,New Jersey Tech,-4
2021-04-09,@Massachusetts-Lowell,4,5,Stony Brook,-1
2021-04-09,@Massachusetts-Lowell,2,6,Stony Brook,-4
2021-04-10,@Massachusetts-Lowell,4,3,Stony Brook,1
2021-04-10,@Massachusetts-Lowell,2,9,Stony Brook,-7
2021-04-17,@Albany,4,18,Albany,-14
2021-04-17,@Albany,5,2,Albany,3
2021-04-18,@Albany,10,11,Albany,-1
2021-04-18,@Albany,1,4,Albany,-3
2021-04-23,@Massachusetts-Lowell,7,11,Maine,-4
2021-04-23,@Massachusetts-Lowell,5,1,Maine,4
2021-04-24,@Massachusetts-Lowell,9,4,Maine,5
2021-04-24,@Massachusetts-Lowell,2,1,Maine,1
2021-05-01,@Hartford,7,6,Hartford,1
2021-05-01,@Hartford,2,8,Hartford,-6
2021-05-02,@Hartford,4,11,Hartford,-7
2021-05-02,@Hartford,8,9,Hartford,-1
2021-05-08,@Maine,6,4,Maine,2
2021-05-08,@Maine,2,3,Maine,-1
2021-05-09,@Maine,1,0,Maine,1
2021-05-09,@Maine,10,3,Maine,7
2021-05-15,@Massachusetts-Lowell,4,3,Albany,1
2021-05-15,@Massachusetts-Lowell,4,7,Albany,-3
2021-05-16,@Massachusetts-Lowell,3,4,Albany,-1
2021-05-16,@Massachusetts-Lowell,7,6,Albany,1
2021-05-21,@Massachusetts-Lowell,7,4,Hartford,3
2021-05-21,@Massachusetts-Lowell,7,1,Hartford,6
2021-05-22,@Massachusetts-Lowell,0,3,Hartford,-3
2021-05-22,@Massachusetts-Lowell,5,7,Hartford,-2
2021-02-19,@Alabama,6,10,Alabama,-4
2021-02-20,@Alabama,3,4,Alabama,-1
2021-02-21,@Alabama,5,9,Alabama,-4
2021-02-26,@McNeese State,5,0,Prairie View A&M,5
2021-02-27,@McNeese State,3,1,Prairie View A&M,2
2021-02-27,@McNeese State,6,5,Prairie View A&M,1
2021-02-28,@McNeese State,11,5,Prairie View A&M,6
2021-03-03,@McNeese State,4,3,Louisiana-Lafayette,1
2021-03-05,@Louisiana Tech,0,11,Louisiana Tech,-11
2021-03-06,@Louisiana Tech,3,4,Louisiana Tech,-1
2021-03-07,@Louisiana Tech,4,14,Louisiana Tech,-10
2021-03-12,@McNeese State,4,2,Texas A&M-Corpus Christi,2
2021-03-13,@McNeese State,9,8,Texas A&M-Corpus Christi,1
2021-03-14,@McNeese State,12,7,Texas A&M-Corpus Christi,5
2021-03-16,@McNeese State,16,6,LSU-Alexandria,10
2021-03-19,@Houston Baptist,12,6,Houston Baptist,6
2021-03-20,@Houston Baptist,7,1,Houston Baptist,6
2021-03-20,@Houston Baptist,3,7,Houston Baptist,-4
2021-03-21,@Houston Baptist,10,0,Houston Baptist,10
2021-03-26,@McNeese State,5,8,Stephen F. Austin State,-3
2021-03-27,@McNeese State,2,5,Stephen F. Austin State,-3
2021-03-27,@McNeese State,3,4,Stephen F. Austin State,-1
2021-03-28,@McNeese State,0,2,Stephen F. Austin State,-2
2021-04-01,@Southeastern Louisiana,6,4,Southeastern Louisiana,2
2021-04-02,@Southeastern Louisiana,3,6,Southeastern Louisiana,-3
2021-04-02,@Southeastern Louisiana,5,0,Southeastern Louisiana,5
2021-04-03,@Southeastern Louisiana,9,13,Southeastern Louisiana,-4
2021-04-06,@Louisiana State,1,14,Louisiana State,-13
2021-04-09,@McNeese State,10,6,Incarnate Word,4
2021-04-10,@McNeese State,4,1,Incarnate Word,3
2021-04-10,@McNeese State,19,1,Incarnate Word,18
2021-04-11,@McNeese State,10,4,Incarnate Word,6
2021-04-17,@Sam Houston State,5,6,Sam Houston State,-1
2021-04-17,@Sam Houston State,2,6,Sam Houston State,-4
2021-04-18,@Sam Houston State,4,6,Sam Houston State,-2
2021-04-18,@Sam Houston State,4,5,Sam Houston State,-1
2021-04-21,@Louisiana-Lafayette,3,4,Louisiana-Lafayette,-1
2021-04-24,@McNeese State,5,6,Texas-Arlington,-1
2021-04-24,@McNeese State,1,8,Texas-Arlington,-7
2021-04-25,@McNeese State,5,3,Texas-Arlington,2
2021-04-30,@McNeese State,8,6,New Orleans,2
2021-05-01,@McNeese State,4,8,New Orleans,-4
2021-05-01,@McNeese State,8,3,New Orleans,5
2021-05-02,@McNeese State,10,13,New Orleans,-3
2021-05-07,@Northwestern State,7,1,Northwestern State,6
2021-05-07,@Northwestern State,3,4,Northwestern State,-1
2021-05-08,@Northwestern State,5,6,Northwestern State,-1
2021-05-08,@Northwestern State,3,4,Northwestern State,-1
2021-05-14,@McNeese State,7,0,Nicholls State,7
2021-05-15,@McNeese State,13,3,Nicholls State,10
2021-05-15,@McNeese State,10,7,Nicholls State,3
2021-05-16,@McNeese State,6,5,Nicholls State,1
2021-05-20,@Central Arkansas,1,8,Central Arkansas,-7
2021-05-21,@Central Arkansas,6,5,Central Arkansas,1
2021-05-21,@Central Arkansas,6,1,Central Arkansas,5
2021-05-22,@Central Arkansas,4,5,Central Arkansas,-1
2021-05-26,@New Orleans,12,0,New Orleans,12
2021-05-27,@McNeese State,3,2,Southeastern Louisiana,1
2021-05-28,@Southeastern Louisiana,18,2,Southeastern Louisiana,16
2021-05-29,@McNeese State,2,1,Sam Houston State,1
2021-06-04,@Texas Christian,4,12,Texas Christian,-8
2021-06-05,@McNeese State,5,10,Oregon State,-5
2021-02-23,@Lipscomb,3,1,Lipscomb,2
2021-02-26,@Memphis,11,9,Grambling State,2
2021-02-27,@Memphis,11,3,Grambling State,8
2021-02-28,@Memphis,17,3,Grambling State,14
2021-03-02,@Mississippi,4,16,Mississippi,-12
2021-03-05,@Baylor,4,5,Baylor,-1
2021-03-06,@Baylor,0,9,Baylor,-9
2021-03-06,@Baylor,4,20,Baylor,-16
2021-03-07,@Baylor,7,8,Baylor,-1
2021-03-09,@Vanderbilt,4,10,Vanderbilt,-6
2021-03-12,@Memphis,0,9,"Miami, Ohio",-9
2021-03-13,@Memphis,5,2,"Miami, Ohio",3
2021-03-14,@Memphis,4,2,"Miami, Ohio",2
2021-03-19,@Memphis,1,0,Middle Tennessee State,1
2021-03-20,@Memphis,1,0,Middle Tennessee State,1
2021-03-20,@Memphis,2,8,Middle Tennessee State,-6
2021-03-21,@Memphis,8,7,Middle Tennessee State,1
2021-03-23,@Arkansas,1,14,Arkansas,-13
2021-03-24,@Arkansas,4,9,Arkansas,-5
2021-03-26,@Memphis,5,9,Murray State,-4
2021-03-28,@Memphis,6,1,Murray State,5
2021-03-28,@Memphis,2,4,Murray State,-2
2021-04-01,@Tulane,4,3,Tulane,1
2021-04-02,@Tulane,1,7,Tulane,-6
2021-04-02,@Tulane,2,11,Tulane,-9
2021-04-03,@Tulane,2,8,Tulane,-6
2021-04-09,@East Carolina,3,5,East Carolina,-2
2021-04-09,@East Carolina,2,12,East Carolina,-10
2021-04-10,@East Carolina,7,8,East Carolina,-1
2021-04-11,@East Carolina,1,7,East Carolina,-6
2021-04-16,@Memphis,6,10,Cincinnati,-4
2021-04-16,@Memphis,3,11,Cincinnati,-8
2021-04-17,@Memphis,7,5,Cincinnati,2
2021-04-18,@Memphis,4,8,Cincinnati,-4
2021-04-23,@Memphis,2,4,Tulane,-2
2021-04-23,@Memphis,2,13,Tulane,-11
2021-04-24,@Memphis,0,5,Tulane,-5
2021-04-25,@Memphis,3,12,Tulane,-9
2021-04-30,@Central Florida,12,2,Central Florida,10
2021-04-30,@Central Florida,10,12,Central Florida,-2
2021-05-01,@Central Florida,6,13,Central Florida,-7
2021-05-02,@Central Florida,5,17,Central Florida,-12
2021-05-07,@Memphis,3,1,South Florida,2
2021-05-07,@Memphis,2,9,South Florida,-7
2021-05-08,@Memphis,5,6,South Florida,-1
2021-05-08,@Memphis,4,7,South Florida,-3
2021-05-14,@Memphis,13,7,Houston,6
2021-05-14,@Memphis,1,2,Houston,-1
2021-05-15,@Memphis,5,7,Houston,-2
2021-05-16,@Memphis,8,4,Houston,4
2021-05-20,@Wichita State,5,8,Wichita State,-3
2021-05-20,@Wichita State,5,12,Wichita State,-7
2021-05-21,@Wichita State,5,9,Wichita State,-4
2021-05-22,@Wichita State,9,4,Wichita State,5
2021-05-25,@East Carolina,11,1,East Carolina,10
2021-05-27,@Central Florida,1,17,Central Florida,-16
2021-05-28,@East Carolina,0,12,East Carolina,-12
2021-02-20,@Mercer,10,0,Jackson State,10
2021-02-20,@Mercer,9,0,Jackson State,9
2021-02-21,@Mercer,14,0,Jackson State,14
2021-02-24,@Georgia Tech,3,7,Georgia Tech,-4
2021-02-26,@Mercer,7,17,Southern Illinois,-10
2021-02-27,@Mercer,5,11,Southern Illinois,-6
2021-02-28,@Mercer,2,5,Southern Illinois,-3
2021-03-05,@South Carolina,1,5,South Carolina,-4
2021-03-06,@South Carolina,0,4,South Carolina,-4
2021-03-07,@South Carolina,0,1,South Carolina,-1
2021-03-10,@Mercer,10,3,Florida A&M,7
2021-03-12,@Mercer,3,1,Marshall,2
2021-03-13,@Mercer,10,11,Marshall,-1
2021-03-14,@Mercer,9,19,Marshall,-10
2021-03-16,@Florida A&M,13,4,Florida A&M,9
2021-03-17,@Florida A&M,10,6,Florida A&M,4
2021-03-19,@Mercer,11,9,Bradley,2
2021-03-20,@Mercer,15,5,Bradley,10
2021-03-20,@Mercer,12,11,Bradley,1
2021-03-23,@Georgia State,5,3,Georgia State,2
2021-03-26,@Mercer,6,4,Wofford,2
2021-03-27,@Mercer,13,7,Wofford,6
2021-03-27,@Mercer,2,12,Wofford,-10
2021-03-31,@Florida State,1,8,Florida State,-7
2021-04-02,@The Citadel,12,2,The Citadel,10
2021-04-03,@The Citadel,6,5,The Citadel,1
2021-04-03,@The Citadel,12,2,The Citadel,10
2021-04-06,@Mercer,5,1,Georgia State,4
2021-04-10,@Mercer,7,4,North Carolina-Greensboro,3
2021-04-11,@Mercer,7,3,North Carolina-Greensboro,4
2021-04-11,@Mercer,17,0,North Carolina-Greensboro,17
2021-04-14,@Georgia Southern,2,3,Georgia Southern,-1
2021-04-16,@VMI,3,4,VMI,-1
2021-04-17,@VMI,4,5,VMI,-1
2021-04-17,@VMI,0,10,VMI,-10
2021-04-21,@Mercer,17,4,Georgia State,13
2021-04-23,@Samford,9,10,Samford,-1
2021-04-23,@Samford,12,5,Samford,7
2021-04-24,@Samford,5,4,Samford,1
2021-04-28,@Kennesaw State,12,10,Kennesaw State,2
2021-04-30,@Mercer,13,8,East Tennessee State,5
2021-05-01,@Mercer,8,4,East Tennessee State,4
2021-05-01,@Mercer,6,7,East Tennessee State,-1
2021-05-05,@Mercer,10,0,Kennesaw State,10
2021-05-07,@Western Carolina,8,7,Western Carolina,1
2021-05-07,@Western Carolina,11,9,Western Carolina,2
2021-05-08,@Western Carolina,14,1,Western Carolina,13
2021-05-11,@Georgia State,7,4,Georgia State,3
2021-05-14,@Mercer,5,1,The Citadel,4
2021-05-15,@Mercer,8,5,The Citadel,3
2021-05-15,@Mercer,7,8,The Citadel,-1
2021-05-18,@Mercer,5,1,Georgia Southern,4
2021-05-20,@Wofford,7,5,Wofford,2
2021-05-21,@Wofford,3,10,Wofford,-7
2021-05-21,@Wofford,0,6,Wofford,-6
2021-05-27,@Samford,8,10,Samford,-2
2021-05-28,@Wofford,7,8,Wofford,-1
2021-02-19,@Florida,5,7,Florida,-2
2021-02-20,@Florida,10,9,Florida,1
2021-02-21,@Florida,8,6,Florida,2
2021-02-26,"@Miami, Florida",3,5,Virginia Tech,-2
2021-02-27,"@Miami, Florida",3,0,Virginia Tech,3
2021-02-28,"@Miami, Florida",6,9,Virginia Tech,-3
2021-03-05,@North Carolina State,5,11,North Carolina State,-6
2021-03-06,@North Carolina State,6,4,North Carolina State,2
2021-03-07,@North Carolina State,6,4,North Carolina State,2
2021-03-09,"@Miami, Florida",11,2,Florida Atlantic,9
2021-03-12,"@Miami, Florida",10,0,Wake Forest,10
2021-03-13,"@Miami, Florida",6,3,Wake Forest,3
2021-03-17,@Florida Gulf Coast,15,2,Florida Gulf Coast,13
2021-03-19,"@Miami, Florida",1,13,Florida State,-12
2021-03-20,"@Miami, Florida",1,9,Florida State,-8
2021-03-21,"@Miami, Florida",0,12,Florida State,-12
2021-03-23,@Florida Atlantic,14,9,Florida Atlantic,5
2021-03-26,@Virginia,8,6,Virginia,2
2021-03-27,@Virginia,0,4,Virginia,-4
2021-03-28,@Virginia,4,2,Virginia,2
2021-03-31,@Florida International,21,1,Florida International,20
2021-04-02,"@Miami, Florida",3,1,Duke,2
2021-04-03,"@Miami, Florida",11,5,Duke,6
2021-04-04,"@Miami, Florida",7,1,Duke,6
2021-04-07,"@Miami, Florida",8,3,Florida International,5
2021-04-09,@Pittsburgh,6,12,Pittsburgh,-6
2021-04-10,@Pittsburgh,4,6,Pittsburgh,-2
2021-04-11,@Pittsburgh,5,12,Pittsburgh,-7
2021-04-14,"@Miami, Florida",3,2,Florida Gulf Coast,1
2021-04-16,"@Miami, Florida",12,3,Clemson,9
2021-04-17,"@Miami, Florida",10,2,Clemson,8
2021-04-18,"@Miami, Florida",3,2,Clemson,1
2021-04-23,@North Carolina,5,6,North Carolina,-1
2021-04-23,@North Carolina,2,4,North Carolina,-2
2021-04-25,@North Carolina,8,1,North Carolina,7
2021-04-27,"@Miami, Florida",6,0,Florida Gulf Coast,6
2021-04-30,@Boston College,0,13,Boston College,-13
2021-05-01,@Boston College,2,1,Boston College,1
2021-05-02,@Boston College,6,11,Boston College,-5
2021-05-07,"@Miami, Florida",4,2,Appalachian State,2
2021-05-08,"@Miami, Florida",16,1,Appalachian State,15
2021-05-09,"@Miami, Florida",10,2,Appalachian State,8
2021-05-14,"@Miami, Florida",3,14,Georgia Tech,-11
2021-05-15,"@Miami, Florida",10,3,Georgia Tech,7
2021-05-16,"@Miami, Florida",5,4,Georgia Tech,1
2021-05-18,"@Miami, Florida",0,3,Florida Atlantic,-3
2021-05-20,@Louisville,6,1,Louisville,5
2021-05-21,@Louisville,2,0,Louisville,2
2021-05-22,@Louisville,3,2,Louisville,1
2021-05-27,@Duke,2,3,Duke,-1
2021-05-28,"@Miami, Florida",3,6,Florida State,-3
2021-06-04,"@Miami, Florida",1,0,South Alabama,1
2021-06-05,@South Florida,2,10,South Florida,-8
2021-06-06,@South Alabama,2,7,South Alabama,-5
2021-02-20,@Jacksonville,4,1,Jacksonville,3
2021-02-20,@Jacksonville,8,4,Jacksonville,4
2021-02-21,@Jacksonville,5,2,Jacksonville,3
2021-02-23,@Kentucky,1,5,Kentucky,-4
2021-02-26,@Florida International,1,3,Florida International,-2
2021-02-27,@Florida International,4,8,Florida International,-4
2021-02-27,@Florida International,21,4,Florida International,17
2021-02-28,@Florida International,15,6,Florida International,9
2021-03-05,@Connecticut,0,5,Connecticut,-5
2021-03-06,@Coastal Carolina,3,5,Coastal Carolina,-2
2021-03-07,"@Miami, Ohio",11,3,Davidson,8
2021-03-12,@Memphis,9,0,Memphis,9
2021-03-13,@Memphis,2,5,Memphis,-3
2021-03-14,@Memphis,2,4,Memphis,-2
2021-03-19,"@Miami, Ohio",9,6,Toledo,3
2021-03-20,"@Miami, Ohio",3,4,Toledo,-1
2021-03-20,"@Miami, Ohio",2,1,Toledo,1
2021-03-21,"@Miami, Ohio",5,2,Toledo,3
2021-03-26,"@Miami, Ohio",4,3,Northern Illinois,1
2021-03-27,"@Miami, Ohio",7,6,Northern Illinois,1
2021-03-27,"@Miami, Ohio",3,1,Northern Illinois,2
2021-03-28,"@Miami, Ohio",7,10,Northern Illinois,-3
2021-04-02,@Eastern Michigan,4,3,Eastern Michigan,1
2021-04-03,@Eastern Michigan,4,1,Eastern Michigan,3
2021-04-03,@Eastern Michigan,5,0,Eastern Michigan,5
2021-04-04,@Eastern Michigan,5,4,Eastern Michigan,1
2021-04-09,"@Miami, Ohio",0,9,Western Michigan,-9
2021-04-09,"@Miami, Ohio",3,4,Western Michigan,-1
2021-04-10,"@Miami, Ohio",2,3,Western Michigan,-1
2021-04-11,"@Miami, Ohio",16,9,Western Michigan,7
2021-04-23,"@Miami, Ohio",2,3,Kent State,-1
2021-04-23,"@Miami, Ohio",1,0,Kent State,1
2021-04-24,"@Miami, Ohio",1,4,Kent State,-3
2021-04-25,"@Miami, Ohio",3,6,Kent State,-3
2021-04-30,@Central Michigan,0,14,Central Michigan,-14
2021-05-01,@Central Michigan,3,6,Central Michigan,-3
2021-05-01,@Central Michigan,1,2,Central Michigan,-1
2021-05-02,@Central Michigan,1,3,Central Michigan,-2
2021-05-04,@Bowling Green State,1,7,Bowling Green State,-6
2021-05-07,@Ohio,0,1,Ohio,-1
2021-05-07,@Ohio,1,3,Ohio,-2
2021-05-08,@Ohio,6,1,Ohio,5
2021-05-08,@Ohio,11,5,Ohio,6
2021-05-14,@West Virginia,6,7,West Virginia,-1
2021-05-15,@West Virginia,3,6,West Virginia,-3
2021-05-18,@Bowling Green State,3,4,Bowling Green State,-1
2021-05-18,@Bowling Green State,0,2,Bowling Green State,-2
2021-05-21,"@Miami, Ohio",3,2,Akron,1
2021-05-22,"@Miami, Ohio",6,2,Akron,4
2021-05-22,"@Miami, Ohio",9,2,Akron,7
2021-05-23,"@Miami, Ohio",6,1,Akron,5
2021-05-25,@Bowling Green State,7,9,Bowling Green State,-2
2021-05-29,@Ball State,2,12,Ball State,-10
2021-05-29,@Ball State,0,1,Ball State,-1
2021-05-30,@Ball State,0,4,Ball State,-4
2021-05-30,@Ball State,2,5,Ball State,-3
2021-03-06,@Iowa,4,2,Iowa,2
2021-03-07,@Iowa,3,8,Iowa,-5
2021-03-07,@Iowa,7,0,Iowa,7
2021-03-08,@Iowa,11,4,Iowa,7
2021-03-12,@Michigan,9,1,Purdue,8
2021-03-13,@Michigan,4,0,Purdue,4
2021-03-13,@Michigan,9,2,Purdue,7
2021-03-14,@Michigan,11,6,Purdue,5
2021-03-19,@Michigan,4,7,Illinois,-3
2021-03-20,@Michigan,8,1,Illinois,7
2021-03-21,@Michigan,8,7,Michigan State,1
2021-03-22,@Michigan,0,3,Michigan State,-3
2021-03-26,@Penn State,2,3,Penn State,-1
2021-03-27,@Penn State,17,4,Penn State,13
2021-03-27,@Penn State,8,6,Penn State,2
2021-04-03,@Michigan,5,2,Northwestern,3
2021-04-04,@Northwestern,1,4,Northwestern,-3
2021-04-04,@Maryland,6,5,Maryland,1
2021-04-05,@Maryland,7,17,Maryland,-10
2021-04-09,@Michigan,4,7,Ohio State,-3
2021-04-10,@Michigan,7,0,Ohio State,7
2021-04-11,@Michigan,16,7,Ohio State,9
2021-04-16,@Minnesota,21,5,Minnesota,16
2021-04-17,@Minnesota,4,0,Minnesota,4
2021-04-18,@Minnesota,9,5,Minnesota,4
2021-04-23,@Michigan,6,4,Rutgers,2
2021-04-24,@Michigan,2,4,Rutgers,-2
2021-04-25,@Michigan,2,3,Rutgers,-1
2021-05-01,@Illinois,18,8,Illinois,10
2021-05-01,@Illinois,4,5,Illinois,-1
2021-05-02,@Michigan,19,4,Illinois,15
2021-05-02,@Michigan,7,13,Illinois,-6
2021-05-07,@Michigan State,5,1,Michigan State,4
2021-05-08,@Michigan State,3,1,Michigan State,2
2021-05-09,@Michigan State,2,10,Michigan State,-8
2021-05-14,@Michigan,10,3,Indiana,7
2021-05-15,@Michigan,8,13,Indiana,-5
2021-05-16,@Michigan,6,1,Indiana,5
2021-05-21,@Michigan,8,11,Maryland,-3
2021-05-22,@Michigan,14,3,Maryland,11
2021-05-23,@Michigan,3,7,Maryland,-4
2021-05-28,@Nebraska,0,1,Nebraska,-1
2021-05-29,@Nebraska,3,5,Nebraska,-2
2021-05-29,@Nebraska,2,0,Nebraska,2
2021-06-04,@Connecticut,1,6,Connecticut,-5
2021-06-05,@Central Michigan,2,8,Central Michigan,-6
2021-03-05,@Michigan State,6,0,Maryland,6
2021-03-06,@Michigan State,5,4,Maryland,1
2021-03-06,@Michigan State,7,4,Maryland,3
2021-03-07,@Michigan State,2,3,Maryland,-1
2021-03-12,@Northwestern,2,14,Northwestern,-12
2021-03-13,@Northwestern,12,3,Northwestern,9
2021-03-13,@Northwestern,2,4,Northwestern,-2
2021-03-14,@Northwestern,5,7,Northwestern,-2
2021-03-20,@Michigan State,11,0,Illinois,11
2021-03-21,@Michigan,7,8,Michigan,-1
2021-03-21,@Illinois,3,7,Illinois,-4
2021-03-22,@Michigan,3,0,Michigan,3
2021-03-26,@Michigan State,2,8,Indiana,-6
2021-03-27,@Michigan State,4,10,Indiana,-6
2021-03-28,@Michigan State,5,1,Indiana,4
2021-04-02,@Minnesota,7,6,Minnesota,1
2021-04-03,@Minnesota,9,10,Minnesota,-1
2021-04-04,@Minnesota,10,7,Minnesota,3
2021-04-09,@Michigan State,7,4,Penn State,3
2021-04-09,@Michigan State,3,7,Penn State,-4
2021-04-11,@Michigan State,5,2,Purdue,3
2021-04-12,@Michigan State,2,8,Purdue,-6
2021-04-16,@Illinois,4,13,Illinois,-9
2021-04-17,@Purdue,1,2,Purdue,-1
2021-04-17,@Illinois,8,15,Illinois,-7
2021-04-18,@Michigan State,3,8,Purdue,-5
2021-04-23,@Michigan State,0,4,Nebraska,-4
2021-04-24,@Michigan State,4,2,Nebraska,2
2021-04-25,@Michigan State,6,9,Nebraska,-3
2021-04-30,@Penn State,6,7,Penn State,-1
2021-05-01,@Penn State,4,27,Penn State,-23
2021-05-02,@Penn State,3,5,Penn State,-2
2021-05-07,@Michigan State,1,5,Michigan,-4
2021-05-08,@Michigan State,1,3,Michigan,-2
2021-05-09,@Michigan State,10,2,Michigan,8
2021-05-14,@Ohio State,10,7,Ohio State,3
2021-05-15,@Ohio State,2,0,Ohio State,2
2021-05-16,@Ohio State,3,7,Ohio State,-4
2021-05-21,@Rutgers,12,1,Rutgers,11
2021-05-22,@Rutgers,8,15,Rutgers,-7
2021-05-23,@Rutgers,14,8,Rutgers,6
2021-05-28,@Michigan State,1,12,Iowa,-11
2021-05-29,@Michigan State,4,7,Iowa,-3
2021-05-30,@Michigan State,3,11,Iowa,-8
2021-03-05,@Minnesota,2,5,Indiana,-3
2021-03-06,@Minnesota,1,16,Rutgers,-15
2021-03-07,@Minnesota,13,8,Rutgers,5
2021-03-07,@Minnesota,1,8,Indiana,-7
2021-03-12,@Minnesota,1,6,Illinois,-5
2021-03-13,@Minnesota,8,11,Illinois,-3
2021-03-13,@Minnesota,1,7,Illinois,-6
2021-03-14,@Minnesota,5,3,Illinois,2
2021-03-20,@Minnesota,3,4,Northwestern,-1
2021-03-21,@Minnesota,3,10,Northwestern,-7
2021-03-22,@Minnesota,7,3,Northwestern,4
2021-03-26,@Nebraska,1,6,Nebraska,-5
2021-03-27,@Nebraska,4,6,Nebraska,-2
2021-03-27,@Nebraska,5,17,Nebraska,-12
2021-03-28,@Nebraska,2,10,Nebraska,-8
2021-04-02,@Minnesota,6,7,Michigan State,-1
2021-04-03,@Minnesota,10,9,Michigan State,1
2021-04-04,@Minnesota,7,10,Michigan State,-3
2021-04-09,@Iowa,1,7,Iowa,-6
2021-04-11,@Iowa,0,18,Iowa,-18
2021-04-11,@Iowa,1,6,Iowa,-5
2021-04-16,@Minnesota,5,21,Michigan,-16
2021-04-17,@Minnesota,0,4,Michigan,-4
2021-04-18,@Minnesota,5,9,Michigan,-4
2021-04-23,@Indiana,3,9,Indiana,-6
2021-04-23,@Indiana,1,7,Indiana,-6
2021-04-25,@Indiana,1,23,Indiana,-22
2021-04-30,@Maryland,4,12,Maryland,-8
2021-05-01,@Maryland,3,4,Maryland,-1
2021-05-02,@Maryland,3,6,Maryland,-3
2021-05-20,@Minnesota,3,9,Purdue,-6
2021-05-21,@Minnesota,5,12,Purdue,-7
2021-05-22,@Minnesota,4,17,Purdue,-13
2021-05-23,@Minnesota,9,8,Purdue,1
2021-05-29,@Minnesota,3,7,Penn State,-4
2021-05-30,@Purdue,2,1,Purdue,1
2021-05-30,@Purdue,6,7,Purdue,-1
2021-02-20,@Texas Christian,7,3,Texas Christian,4
2021-02-21,@Mississippi,5,4,Texas Tech,1
2021-02-22,@Texas,8,1,Texas,7
2021-02-24,@Mississippi,12,1,Arkansas State,11
2021-02-26,@Mississippi,2,3,Central Florida,-1
2021-02-27,@Mississippi,2,7,Central Florida,-5
2021-02-27,@Mississippi,6,5,Central Florida,1
2021-03-02,@Mississippi,16,4,Memphis,12
2021-03-03,@Mississippi,12,1,Jackson State,11
2021-03-05,@Mississippi,12,4,Belmont,8
2021-03-06,@Mississippi,4,3,Belmont,1
2021-03-07,@Mississippi,8,7,Belmont,1
2021-03-09,@Mississippi,11,1,Alcorn State,10
2021-03-12,@Mississippi,10,1,Louisiana-Monroe,9
2021-03-13,@Mississippi,6,5,Louisiana-Monroe,1
2021-03-14,@Mississippi,3,8,Louisiana-Monroe,-5
2021-03-16,@Louisiana Tech,1,13,Louisiana Tech,-12
2021-03-19,@Mississippi,1,0,Auburn,1
2021-03-20,@Mississippi,6,5,Auburn,1
2021-03-21,@Mississippi,19,11,Auburn,8
2021-03-23,@Mississippi,5,2,Central Arkansas,3
2021-03-26,@Alabama,2,0,Alabama,2
2021-03-26,@Alabama,9,6,Alabama,3
2021-03-27,@Alabama,11,6,Alabama,5
2021-04-01,@Florida,1,4,Florida,-3
2021-04-02,@Florida,8,2,Florida,6
2021-04-03,@Florida,5,6,Florida,-1
2021-04-05,@Mississippi,20,6,North Alabama,14
2021-04-06,@Mississippi,8,1,Alcorn State,7
2021-04-10,@Mississippi,3,7,Arkansas,-4
2021-04-10,@Mississippi,13,6,Arkansas,7
2021-04-11,@Mississippi,14,18,Arkansas,-4
2021-04-13,@Mississippi,13,1,Austin Peay State,12
2021-04-16,@Mississippi State,2,5,Mississippi State,-3
2021-04-17,@Mississippi State,9,0,Mississippi State,9
2021-04-18,@Mississippi State,5,7,Mississippi State,-2
2021-04-20,@Mississippi,11,6,Arkansas-Little Rock,5
2021-04-22,@Mississippi,4,5,Louisiana State,-1
2021-04-23,@Mississippi,2,7,Louisiana State,-5
2021-04-24,@Mississippi,10,9,Louisiana State,1
2021-04-30,@Mississippi,5,1,South Carolina,4
2021-05-01,@Mississippi,6,4,South Carolina,2
2021-05-01,@Mississippi,7,3,South Carolina,4
2021-05-04,@Mississippi,15,12,Arkansas State,3
2021-05-07,@Texas A&M,8,9,Texas A&M,-1
2021-05-08,@Texas A&M,12,7,Texas A&M,5
2021-05-09,@Texas A&M,5,6,Texas A&M,-1
2021-05-12,@Mississippi,9,4,Arkansas-Little Rock,5
2021-05-14,@Mississippi,3,1,Vanderbilt,2
2021-05-15,@Mississippi,2,13,Vanderbilt,-11
2021-05-16,@Mississippi,13,10,Vanderbilt,3
2021-05-18,@Mississippi,7,9,Tennessee-Martin,-2
2021-05-20,@Georgia,2,0,Georgia,2
2021-05-21,@Georgia,8,5,Georgia,3
2021-05-22,@Georgia,2,13,Georgia,-11
2021-05-25,@Mississippi,7,4,Auburn,3
2021-05-26,@Vanderbilt,4,5,Vanderbilt,-1
2021-05-27,@Mississippi,4,0,Georgia,4
2021-05-28,@Vanderbilt,4,1,Vanderbilt,3
2021-05-29,@Mississippi,2,3,Arkansas,-1
2021-06-04,@Mississippi,6,3,Southeast Missouri State,3
2021-06-05,@Florida State,4,3,Florida State,1
2021-06-06,@Southern Mississippi,7,10,Southern Mississippi,-3
2021-06-07,@Mississippi,12,9,Southern Mississippi,3
2021-06-11,@Arizona,3,9,Arizona,-6
2021-06-12,@Mississippi,12,3,Arizona,9
2021-06-13,@Arizona,3,16,Arizona,-13
2021-02-20,@Texas,8,3,Texas,5
2021-02-21,@Mississippi State,2,3,Texas Christian,-1
2021-02-22,@Texas Tech,11,5,Texas Tech,6
2021-02-24,@Mississippi State,7,3,Jackson State,4
2021-02-26,@Mississippi State,3,7,Tulane,-4
2021-02-27,@Mississippi State,9,5,Tulane,4
2021-02-28,@Mississippi State,5,4,Tulane,1
2021-03-03,@Mississippi State,4,1,Southern Mississippi,3
2021-03-05,@Mississippi State,8,3,Kent State,5
2021-03-06,@Mississippi State,5,9,Kent State,-4
2021-03-07,@Mississippi State,13,0,Kent State,13
2021-03-09,@Mississippi State,10,0,Grambling State,10
2021-03-10,@Mississippi State,4,0,Louisiana-Lafayette,4
2021-03-12,@Mississippi State,14,0,Eastern Michigan,14
2021-03-13,@Mississippi State,4,1,Eastern Michigan,3
2021-03-14,@Mississippi State,4,1,Eastern Michigan,3
2021-03-16,@Mississippi State,10,2,Samford,8
2021-03-19,@Louisiana State,6,1,Louisiana State,5
2021-03-20,@Louisiana State,3,0,Louisiana State,3
2021-03-21,@Louisiana State,3,8,Louisiana State,-5
2021-03-24,@Mississippi State,18,1,North Alabama,17
2021-03-26,@Mississippi State,2,8,Arkansas,-6
2021-03-27,@Mississippi State,5,11,Arkansas,-6
2021-03-28,@Mississippi State,4,6,Arkansas,-2
2021-04-01,@Mississippi State,8,1,Kentucky,7
2021-04-02,@Mississippi State,3,2,Kentucky,1
2021-04-03,@Mississippi State,4,3,Kentucky,1
2021-04-06,@Mississippi State,15,1,Southern,14
2021-04-09,@Auburn,6,5,Auburn,1
2021-04-10,@Auburn,7,2,Auburn,5
2021-04-11,@Auburn,19,10,Auburn,9
2021-04-13,@Mississippi State,18,10,Arkansas State,8
2021-04-16,@Mississippi State,5,2,Mississippi,3
2021-04-17,@Mississippi State,0,9,Mississippi,-9
2021-04-18,@Mississippi State,7,5,Mississippi,2
2021-04-20,@Mississippi State,19,7,Alabama-Birmingham,12
2021-04-23,@Vanderbilt,2,6,Vanderbilt,-4
2021-04-24,@Vanderbilt,7,4,Vanderbilt,3
2021-04-25,@Vanderbilt,4,7,Vanderbilt,-3
2021-04-30,@Mississippi State,8,7,Texas A&M,1
2021-05-01,@Mississippi State,10,5,Texas A&M,5
2021-05-01,@Mississippi State,3,2,Texas A&M,1
2021-05-05,@The Citadel,10,2,The Citadel,8
2021-05-07,@South Carolina,9,0,South Carolina,9
2021-05-08,@South Carolina,9,6,South Carolina,3
2021-05-09,@South Carolina,3,4,South Carolina,-1
2021-05-13,@Mississippi State,5,4,Missouri,1
2021-05-14,@Mississippi State,6,7,Missouri,-1
2021-05-15,@Mississippi State,8,16,Missouri,-8
2021-05-18,@Mississippi State,6,1,Jacksonville State,5
2021-05-20,@Alabama,4,2,Alabama,2
2021-05-21,@Alabama,7,0,Alabama,7
2021-05-22,@Alabama,7,3,Alabama,4
2021-05-26,@Mississippi State,1,13,Florida,-12
2021-05-27,@Tennessee,2,12,Tennessee,-10
2021-06-04,@Mississippi State,8,4,Samford,4
2021-06-05,@Mississippi State,16,4,Virginia Commonwealth,12
2021-06-07,@Campbell,6,5,Campbell,1
2021-06-12,@Mississippi State,9,8,Notre Dame,1
2021-06-13,@Notre Dame,1,9,Notre Dame,-8
2021-06-14,@Mississippi State,11,7,Notre Dame,4
2021-06-20,@Texas,2,1,Texas,1
2021-06-22,@Virginia,6,5,Virginia,1
2021-06-25,@Mississippi State,5,8,Texas,-3
2021-06-26,@Mississippi State,4,3,Texas,1
2021-06-28,@Vanderbilt,2,8,Vanderbilt,-6
2021-06-29,@Mississippi State,13,2,Vanderbilt,11
2021-06-30,@Vanderbilt,9,0,Vanderbilt,9
2021-02-20,@Southeastern Louisiana,0,23,Southeastern Louisiana,-23
2021-02-20,@Southeastern Louisiana,0,26,Southeastern Louisiana,-26
2021-02-21,@Southeastern Louisiana,0,17,Southeastern Louisiana,-17
2021-03-05,@Mississippi Valley State,3,16,Alcorn State,-13
2021-03-06,@Mississippi Valley State,1,9,Alcorn State,-8
2021-03-07,@Mississippi Valley State,1,14,Alcorn State,-13
2021-03-19,@Alabama State,1,10,Alabama State,-9
2021-03-20,@Alabama State,0,14,Alabama State,-14
2021-03-21,@Alabama State,2,8,Alabama State,-6
2021-04-02,@Mississippi Valley State,3,12,Jackson State,-9
2021-04-03,@Mississippi Valley State,0,9,Jackson State,-9
2021-04-04,@Mississippi Valley State,1,13,Jackson State,-12
2021-04-11,@Alcorn State,9,14,Alcorn State,-5
2021-04-16,@Alabama A&M,1,3,Alabama A&M,-2
2021-04-17,@Alabama A&M,9,10,Alabama A&M,-1
2021-04-17,@Alabama A&M,6,21,Alabama A&M,-15
2021-04-18,@Alabama A&M,7,8,Alabama A&M,-1
2021-05-07,@Jackson State,0,6,Jackson State,-6
2021-05-08,@Jackson State,5,19,Jackson State,-14
2021-05-09,@Jackson State,1,12,Jackson State,-11
2021-02-19,@Grand Canyon,3,11,Grand Canyon,-8
2021-02-20,@Grand Canyon,9,7,Grand Canyon,2
2021-02-20,@Grand Canyon,4,8,Grand Canyon,-4
2021-02-21,@Grand Canyon,3,10,Grand Canyon,-7
2021-02-26,@Missouri,12,10,Nebraska-Omaha,2
2021-02-27,@Missouri,11,17,Nebraska-Omaha,-6
2021-02-27,@Missouri,10,1,Nebraska-Omaha,9
2021-02-28,@Missouri,3,9,Nebraska-Omaha,-6
2021-03-04,@Dallas Baptist,2,3,Dallas Baptist,-1
2021-03-05,@Missouri,0,8,Dallas Baptist,-8
2021-03-06,@Oklahoma,6,16,Oklahoma,-10
2021-03-07,@Missouri,4,8,Arizona,-4
2021-03-10,@St. Louis,2,1,St. Louis,1
2021-03-12,@Illinois State,7,0,Illinois State,7
2021-03-13,@Illinois State,12,2,Illinois State,10
2021-03-13,@Illinois State,1,10,Illinois State,-9
2021-03-14,@Illinois State,12,7,Illinois State,5
2021-03-19,@Kentucky,2,10,Kentucky,-8
2021-03-20,@Kentucky,4,5,Kentucky,-1
2021-03-21,@Kentucky,5,3,Kentucky,2
2021-03-25,@Missouri,2,10,Vanderbilt,-8
2021-03-26,@Missouri,3,11,Vanderbilt,-8
2021-03-27,@Missouri,1,3,Vanderbilt,-2
2021-03-30,@Kansas,9,10,Kansas,-1
2021-04-01,@Missouri,2,16,Texas A&M,-14
2021-04-02,@Missouri,8,2,Texas A&M,6
2021-04-03,@Missouri,7,3,Texas A&M,4
2021-04-09,@South Carolina,7,2,South Carolina,5
2021-04-10,@South Carolina,1,11,South Carolina,-10
2021-04-11,@South Carolina,4,13,South Carolina,-9
2021-04-13,@Missouri,5,7,Missouri State,-2
2021-04-16,@Florida,5,8,Florida,-3
2021-04-17,@Florida,4,6,Florida,-2
2021-04-17,@Florida,6,8,Florida,-2
2021-04-23,@Missouri,6,4,Georgia,2
2021-04-24,@Missouri,5,7,Georgia,-2
2021-04-25,@Missouri,4,9,Georgia,-5
2021-04-27,@Kansas State,8,13,Kansas State,-5
2021-04-30,@Alabama,8,11,Alabama,-3
2021-05-01,@Alabama,2,5,Alabama,-3
2021-05-02,@Alabama,2,3,Alabama,-1
2021-05-07,@Missouri,4,5,Tennessee,-1
2021-05-08,@Missouri,4,11,Tennessee,-7
2021-05-09,@Missouri,2,10,Tennessee,-8
2021-05-13,@Mississippi State,4,5,Mississippi State,-1
2021-05-14,@Mississippi State,7,6,Mississippi State,1
2021-05-15,@Mississippi State,16,8,Mississippi State,8
2021-05-18,@Missouri,8,9,Kansas,-1
2021-05-20,@Missouri,6,15,Auburn,-9
2021-05-21,@Missouri,0,3,Auburn,-3
2021-05-22,@Missouri,7,6,Auburn,1
2021-02-23,@Oral Roberts,8,2,Oral Roberts,6
2021-02-24,@Oral Roberts,14,11,Oral Roberts,3
2021-02-26,@Missouri State,6,1,Central Arkansas,5
2021-02-27,@Missouri State,2,5,Central Arkansas,-3
2021-02-28,@Missouri State,12,2,Central Arkansas,10
2021-03-02,@Missouri State,0,7,Oklahoma State,-7
2021-03-06,@Missouri State,5,7,Tarleton State,-2
2021-03-07,@Central Arkansas,15,9,Central Arkansas,6
2021-03-09,@Arkansas State,2,10,Arkansas State,-8
2021-03-10,@Arkansas State,3,7,Arkansas State,-4
2021-03-16,@Missouri State,5,1,Oral Roberts,4
2021-03-19,@Southern Mississippi,1,2,Southern Mississippi,-1
2021-03-20,@Southern Mississippi,0,5,Southern Mississippi,-5
2021-03-21,@Southern Mississippi,1,3,Southern Mississippi,-2
2021-03-23,@Oklahoma State,11,8,Oklahoma State,3
2021-03-30,@Southeast Missouri State,9,8,Southeast Missouri State,1
2021-04-01,@Missouri State,5,4,Bradley,1
2021-04-02,@Missouri State,1,10,Bradley,-9
2021-04-02,@Missouri State,4,3,Bradley,1
2021-04-03,@Missouri State,7,10,Bradley,-3
2021-04-06,@Missouri State,9,8,Drury,1
2021-04-13,@Missouri,7,5,Missouri,2
2021-04-16,@Evansville,5,3,Evansville,2
2021-04-17,@Evansville,3,0,Evansville,3
2021-04-17,@Evansville,2,4,Evansville,-2
2021-04-18,@Evansville,9,5,Evansville,4
2021-04-30,@Southern Illinois,2,3,Southern Illinois,-1
2021-05-01,@Southern Illinois,0,4,Southern Illinois,-4
2021-05-01,@Southern Illinois,5,6,Southern Illinois,-1
2021-05-02,@Southern Illinois,0,5,Southern Illinois,-5
2021-05-05,@Kansas,1,3,Kansas,-2
2021-05-07,@Missouri State,2,7,Indiana State,-5
2021-05-08,@Missouri State,4,3,Indiana State,1
2021-05-09,@Missouri State,2,13,Indiana State,-11
2021-05-09,@Missouri State,2,5,Indiana State,-3
2021-05-14,@Illinois State,2,4,Illinois State,-2
2021-05-15,@Illinois State,3,4,Illinois State,-1
2021-05-15,@Illinois State,1,3,Illinois State,-2
2021-05-16,@Illinois State,2,1,Illinois State,1
2021-05-20,@Missouri State,2,1,Valparaiso,1
2021-05-21,@Missouri State,9,4,Valparaiso,5
2021-05-21,@Missouri State,7,6,Valparaiso,1
2021-05-22,@Missouri State,2,1,Valparaiso,1
2021-05-25,@Missouri State,4,6,Valparaiso,-2
2021-03-20,@Quinnipiac,8,5,Quinnipiac,3
2021-03-20,@Quinnipiac,0,5,Quinnipiac,-5
2021-03-21,@Quinnipiac,11,7,Quinnipiac,4
2021-03-21,@Quinnipiac,5,3,Quinnipiac,2
2021-03-28,@Monmouth,2,0,Manhattan,2
2021-03-29,@Monmouth,10,0,Manhattan,10
2021-03-29,@Monmouth,3,1,Manhattan,2
2021-03-29,@Monmouth,3,1,Manhattan,2
2021-04-02,@Monmouth,5,0,Siena,5
2021-04-02,@Monmouth,6,0,Siena,6
2021-04-03,@Monmouth,13,1,Siena,12
2021-04-03,@Monmouth,2,0,Siena,2
2021-04-07,@Monmouth,7,13,Rider,-6
2021-04-07,@Monmouth,3,1,Rider,2
2021-04-14,@Monmouth,0,1,Rider,-1
2021-04-14,@Monmouth,11,1,Rider,10
2021-04-17,@Fairfield,2,8,Fairfield,-6
2021-04-17,@Fairfield,2,3,Fairfield,-1
2021-04-18,@Fairfield,3,4,Fairfield,-1
2021-04-18,@Fairfield,1,4,Fairfield,-3
2021-05-01,@Monmouth,4,1,Marist,3
2021-05-01,@Monmouth,5,2,Marist,3
2021-05-02,@Monmouth,8,0,Marist,8
2021-05-02,@Monmouth,1,2,Marist,-1
2021-05-08,@St. Peter's,5,0,St. Peter's,5
2021-05-08,@St. Peter's,0,1,St. Peter's,-1
2021-05-09,@St. Peter's,18,5,St. Peter's,13
2021-05-09,@St. Peter's,18,0,St. Peter's,18
2021-05-15,@Monmouth,8,5,Canisius,3
2021-05-15,@Monmouth,12,11,Canisius,1
2021-05-16,@Monmouth,7,4,Canisius,3
2021-05-16,@Monmouth,1,7,Canisius,-6
2021-05-21,@Monmouth,14,2,Siena,12
2021-05-21,@Monmouth,5,13,Siena,-8
2021-05-22,@Monmouth,6,4,Siena,2
2021-05-26,@Monmouth,5,9,Rider,-4
2021-05-27,@Fairfield,1,3,Fairfield,-2
2021-02-19,@North Carolina-Charlotte,4,12,North Carolina-Charlotte,-8
2021-02-20,@North Carolina-Charlotte,3,18,North Carolina-Charlotte,-15
2021-02-20,@Davidson,8,14,Davidson,-6
2021-02-21,@North Carolina-Charlotte,2,4,North Carolina-Charlotte,-2
2021-02-26,@Ohio,0,6,Ohio,-6
2021-02-26,@Ohio,3,1,Ohio,2
2021-03-02,@Louisville,5,2,Louisville,3
2021-03-05,@Marshall,1,3,Marshall,-2
2021-03-06,@Morehead State,13,10,Marshall,3
2021-03-07,@Marshall,6,2,Marshall,4
2021-03-09,@Morehead State,12,9,Ohio,3
2021-03-12,@Morehead State,5,2,Eastern Kentucky,3
2021-03-13,@Morehead State,14,5,Eastern Kentucky,9
2021-03-13,@Morehead State,0,11,Eastern Kentucky,-11
2021-03-16,@West Virginia,1,7,West Virginia,-6
2021-03-17,@West Virginia,2,4,West Virginia,-2
2021-03-20,@Norfolk State,5,1,Norfolk State,4
2021-03-20,@Norfolk State,5,3,Norfolk State,2
2021-03-21,@Norfolk State,10,2,Norfolk State,8
2021-03-21,@Norfolk State,2,4,Norfolk State,-2
2021-04-02,@Morehead State,13,10,Southern Illinois-Edwardsville,3
2021-04-03,@Morehead State,8,12,Southern Illinois-Edwardsville,-4
2021-04-03,@Morehead State,13,8,Southern Illinois-Edwardsville,5
2021-04-06,@Dayton,10,7,Dayton,3
2021-04-08,@Austin Peay State,4,13,Austin Peay State,-9
2021-04-09,@Austin Peay State,14,9,Austin Peay State,5
2021-04-09,@Austin Peay State,12,1,Austin Peay State,11
2021-04-16,@Morehead State,7,4,Eastern Illinois,3
2021-04-16,@Morehead State,11,9,Eastern Illinois,2
2021-04-17,@Morehead State,6,8,Eastern Illinois,-2
2021-04-18,@Morehead State,14,4,Eastern Illinois,10
2021-04-20,@Eastern Kentucky,4,13,Eastern Kentucky,-9
2021-04-24,@Jacksonville State,5,9,Jacksonville State,-4
2021-04-24,@Jacksonville State,3,0,Jacksonville State,3
2021-04-25,@Jacksonville State,6,3,Jacksonville State,3
2021-04-30,@Morehead State,5,3,Murray State,2
2021-04-30,@Morehead State,17,3,Murray State,14
2021-05-01,@Morehead State,3,13,Murray State,-10
2021-05-02,@Morehead State,11,6,Murray State,5
2021-05-07,@Tennessee Tech,2,3,Tennessee Tech,-1
2021-05-08,@Tennessee Tech,7,8,Tennessee Tech,-1
2021-05-08,@Tennessee Tech,3,4,Tennessee Tech,-1
2021-05-21,@Belmont,3,4,Belmont,-1
2021-05-22,@Belmont,5,6,Belmont,-1
2021-05-22,@Belmont,9,6,Belmont,3
2021-05-28,@Morehead State,1,3,Austin Peay State,-2
2021-05-28,@Murray State,7,8,Murray State,-1
2021-02-26,@Richmond,1,2,Richmond,-1
2021-02-26,@Richmond,2,6,Richmond,-4
2021-02-27,@Richmond,8,9,Richmond,-1
2021-02-28,@Richmond,5,7,Richmond,-2
2021-03-04,@Mount St. Mary's,3,2,Bucknell,1
2021-03-05,@Mount St. Mary's,10,9,Coppin State,1
2021-03-06,@Mount St. Mary's,3,7,Coppin State,-4
2021-03-06,@Mount St. Mary's,5,15,Coppin State,-10
2021-03-07,@Mount St. Mary's,7,3,Coppin State,4
2021-03-12,@Mount St. Mary's,13,11,Delaware State,2
2021-03-14,@Mount St. Mary's,11,32,Delaware State,-21
2021-03-14,@Mount St. Mary's,5,11,Delaware State,-6
2021-03-20,@Mount St. Mary's,4,6,LIU-Brooklyn,-2
2021-03-20,@Mount St. Mary's,5,8,LIU-Brooklyn,-3
2021-03-21,@Mount St. Mary's,9,6,LIU-Brooklyn,3
2021-03-23,@Mount St. Mary's,4,8,LaSalle,-4
2021-03-26,@Mount St. Mary's,2,15,Bryant,-13
2021-03-27,@Mount St. Mary's,4,13,Bryant,-9
2021-03-27,@Mount St. Mary's,2,7,Bryant,-5
2021-04-01,@Central Connecticut State,2,6,Central Connecticut State,-4
2021-04-02,@Central Connecticut State,1,5,Central Connecticut State,-4
2021-04-03,@Central Connecticut State,3,5,Central Connecticut State,-2
2021-04-09,@Mount St. Mary's,5,8,Sacred Heart,-3
2021-04-10,@Mount St. Mary's,7,14,Sacred Heart,-7
2021-04-11,@Mount St. Mary's,4,6,Sacred Heart,-2
2021-04-16,@Fairleigh Dickinson,4,10,Fairleigh Dickinson,-6
2021-04-17,@Fairleigh Dickinson,14,3,Fairleigh Dickinson,11
2021-04-18,@Fairleigh Dickinson,6,8,Fairleigh Dickinson,-2
2021-04-23,@Mount St. Mary's,16,4,Wagner,12
2021-04-24,@Mount St. Mary's,3,16,Wagner,-13
2021-04-25,@Mount St. Mary's,7,1,Wagner,6
2021-05-07,@LIU-Brooklyn,0,5,LIU-Brooklyn,-5
2021-05-07,@LIU-Brooklyn,1,0,LIU-Brooklyn,1
2021-05-13,@Mount St. Mary's,2,8,Central Connecticut State,-6
2021-05-14,@Mount St. Mary's,2,5,Central Connecticut State,-3
2021-05-15,@Mount St. Mary's,7,8,Central Connecticut State,-1
2021-05-20,@Bryant,3,20,Bryant,-17
2021-02-22,@Lipscomb,2,4,Lipscomb,-2
2021-02-22,@Lipscomb,2,8,Lipscomb,-6
2021-02-24,@Middle Tennessee State,12,7,Middle Tennessee State,5
2021-02-26,@Murray State,9,5,IPFW,4
2021-02-26,@Murray State,6,10,IPFW,-4
2021-02-27,@Murray State,3,2,IPFW,1
2021-02-27,@Murray State,5,4,IPFW,1
2021-03-02,@Murray State,9,6,Arkansas State,3
2021-03-05,@Arkansas,6,7,Arkansas,-1
2021-03-06,@Arkansas,6,11,Arkansas,-5
2021-03-07,@Arkansas,0,6,Arkansas,-6
2021-03-09,@Louisville,3,8,Louisville,-5
2021-03-12,@Eastern Illinois,9,2,Eastern Illinois,7
2021-03-13,@Eastern Illinois,15,5,Eastern Illinois,10
2021-03-13,@Eastern Illinois,10,14,Eastern Illinois,-4
2021-03-16,@Kentucky,13,8,Kentucky,5
2021-03-19,@Murray State,3,2,Jacksonville State,1
2021-03-20,@Murray State,11,16,Jacksonville State,-5
2021-03-20,@Murray State,11,0,Jacksonville State,11
2021-03-23,@Arkansas State,1,3,Arkansas State,-2
2021-03-26,@Memphis,9,5,Memphis,4
2021-03-28,@Memphis,4,2,Memphis,2
2021-03-28,@Memphis,1,6,Memphis,-5
2021-04-01,@Tennessee Tech,4,2,Tennessee Tech,2
2021-04-02,@Tennessee Tech,7,2,Tennessee Tech,5
2021-04-02,@Tennessee Tech,4,5,Tennessee Tech,-1
2021-04-06,@Murray State,12,8,Bellarmine,4
2021-04-09,@Murray State,8,12,Southeast Missouri State,-4
2021-04-09,@Murray State,3,8,Southeast Missouri State,-5
2021-04-10,@Murray State,11,6,Southeast Missouri State,5
2021-04-17,@Belmont,5,8,Belmont,-3
2021-04-17,@Belmont,2,8,Belmont,-6
2021-04-18,@Belmont,2,0,Belmont,2
2021-04-20,@Bellarmine,10,5,Bellarmine,5
2021-04-23,@Murray State,10,8,Eastern Kentucky,2
2021-04-23,@Murray State,6,3,Eastern Kentucky,3
2021-04-24,@Murray State,7,3,Eastern Kentucky,4
2021-04-27,@Southern Illinois,4,5,Southern Illinois,-1
2021-04-30,@Morehead State,3,17,Morehead State,-14
2021-04-30,@Morehead State,3,5,Morehead State,-2
2021-05-01,@Morehead State,13,3,Morehead State,10
2021-05-02,@Morehead State,6,11,Morehead State,-5
2021-05-05,@Murray State,4,3,Belmont,1
2021-05-07,@Murray State,11,0,Tennessee-Martin,11
2021-05-07,@Murray State,8,5,Tennessee-Martin,3
2021-05-08,@Murray State,6,4,Tennessee-Martin,2
2021-05-11,@Murray State,5,4,Southern Illinois,1
2021-05-14,@Southern Illinois-Edwardsville,17,6,Southern Illinois-Edwardsville,11
2021-05-14,@Southern Illinois-Edwardsville,2,6,Southern Illinois-Edwardsville,-4
2021-05-15,@Southern Illinois-Edwardsville,7,6,Southern Illinois-Edwardsville,1
2021-05-20,@Murray State,3,7,Austin Peay State,-4
2021-05-21,@Murray State,8,3,Austin Peay State,5
2021-05-21,@Murray State,3,9,Austin Peay State,-6
2021-05-28,@Murray State,8,7,Morehead State,1
2021-05-28,@Southeast Missouri State,5,6,Southeast Missouri State,-1
2021-05-29,@Southeast Missouri State,10,1,Southeast Missouri State,9
2021-05-29,@Murray State,7,6,Austin Peay State,1
2021-05-30,@Southeast Missouri State,1,10,Southeast Missouri State,-9
2021-02-21,@Navy,7,2,Coppin State,5
2021-02-24,@Navy,16,11,Coppin State,5
2021-02-27,@Navy,3,2,George Mason,1
2021-02-27,@Navy,7,3,George Mason,4
2021-03-27,@Bucknell,7,1,Bucknell,6
2021-03-27,@Bucknell,1,11,Bucknell,-10
2021-03-28,@Navy,15,10,Bucknell,5
2021-04-03,@Navy,4,3,Lehigh,1
2021-04-03,@Navy,1,5,Lehigh,-4
2021-04-04,@Lehigh,1,3,Lehigh,-2
2021-04-07,@Towson,13,4,Towson,9
2021-04-10,@Lafayette,12,13,Lafayette,-1
2021-04-10,@Lafayette,6,8,Lafayette,-2
2021-04-11,@Navy,10,8,Lafayette,2
2021-04-11,@Navy,8,4,Lafayette,4
2021-04-17,@Navy,2,4,Bucknell,-2
2021-04-17,@Navy,6,5,Bucknell,1
2021-04-18,@Bucknell,3,10,Bucknell,-7
2021-04-24,@Navy,3,9,Holy Cross,-6
2021-04-24,@Navy,14,13,Holy Cross,1
2021-04-25,@Navy,0,8,Holy Cross,-8
2021-04-25,@Navy,13,10,Holy Cross,3
2021-04-28,@Navy,10,12,Coppin State,-2
2021-05-01,@Lehigh,0,2,Lehigh,-2
2021-05-01,@Lehigh,4,8,Lehigh,-4
2021-05-02,@Navy,7,2,Lehigh,5
2021-05-08,@Army,1,6,Army,-5
2021-05-08,@Army,8,7,Army,1
2021-05-09,@Army,10,5,Army,5
2021-05-15,@Lehigh,5,10,Lehigh,-5
2021-05-15,@Lehigh,3,1,Lehigh,2
2021-05-16,@Lehigh,0,5,Lehigh,-5
2021-03-05,@Purdue,5,6,Purdue,-1
2021-03-06,@Purdue,10,0,Purdue,10
2021-03-06,@Purdue,7,2,Purdue,5
2021-03-07,@Purdue,4,0,Purdue,4
2021-03-12,@Nebraska,10,4,Ohio State,6
2021-03-13,@Nebraska,4,0,Iowa,4
2021-03-14,@Nebraska,4,6,Ohio State,-2
2021-03-14,@Nebraska,1,3,Iowa,-2
2021-03-19,@Iowa,0,3,Iowa,-3
2021-03-20,@Iowa,10,8,Iowa,2
2021-03-21,@Iowa,13,8,Iowa,5
2021-03-26,@Nebraska,6,1,Minnesota,5
2021-03-27,@Nebraska,17,5,Minnesota,12
2021-03-27,@Nebraska,6,4,Minnesota,2
2021-03-28,@Nebraska,10,2,Minnesota,8
2021-04-02,@Illinois,8,6,Illinois,2
2021-04-03,@Illinois,8,10,Illinois,-2
2021-04-04,@Illinois,12,7,Illinois,5
2021-04-09,@Nebraska,6,2,Maryland,4
2021-04-10,@Nebraska,7,10,Maryland,-3
2021-04-11,@Nebraska,14,3,Maryland,11
2021-04-16,@Penn State,8,2,Penn State,6
2021-04-17,@Penn State,11,2,Penn State,9
2021-04-18,@Penn State,5,3,Penn State,2
2021-04-23,@Michigan State,4,0,Michigan State,4
2021-04-24,@Michigan State,2,4,Michigan State,-2
2021-04-25,@Michigan State,9,6,Michigan State,3
2021-04-30,@Nebraska,4,9,Rutgers,-5
2021-05-01,@Nebraska,5,6,Rutgers,-1
2021-05-02,@Nebraska,0,6,Rutgers,-6
2021-05-08,@Nebraska,7,6,Indiana,1
2021-05-09,@Indiana,2,4,Indiana,-2
2021-05-09,@Rutgers,15,5,Rutgers,10
2021-05-10,@Rutgers,7,6,Rutgers,1
2021-05-14,@Nebraska,12,2,Northwestern,10
2021-05-15,@Nebraska,11,5,Northwestern,6
2021-05-21,@Indiana,8,5,Indiana,3
2021-05-22,@Indiana,3,1,Indiana,2
2021-05-22,@Ohio State,11,9,Ohio State,2
2021-05-23,@Nebraska,9,0,Ohio State,9
2021-05-28,@Nebraska,1,0,Michigan,1
2021-05-29,@Nebraska,5,3,Michigan,2
2021-05-29,@Nebraska,0,2,Michigan,-2
2021-06-04,@Nebraska,8,6,Northeastern,2
2021-06-05,@Arkansas,1,5,Arkansas,-4
2021-06-06,@Nebraska,18,4,New Jersey Tech,14
2021-06-06,@Nebraska,5,3,Arkansas,2
2021-06-07,@Arkansas,2,6,Arkansas,-4
2021-02-21,@Oklahoma,6,3,Oklahoma,3
2021-02-22,@Oklahoma,5,8,Oklahoma,-3
2021-02-26,@Missouri,10,12,Missouri,-2
2021-02-27,@Missouri,1,10,Missouri,-9
2021-02-27,@Missouri,17,11,Missouri,6
2021-02-28,@Missouri,9,3,Missouri,6
2021-03-05,@Nebraska-Omaha,3,10,Creighton,-7
2021-03-06,@Nebraska-Omaha,2,15,Creighton,-13
2021-03-07,@Nebraska-Omaha,5,2,Creighton,3
2021-03-12,@Nebraska-Omaha,3,7,Kansas,-4
2021-03-12,@Nebraska-Omaha,9,7,Kansas,2
2021-03-13,@Nebraska-Omaha,0,9,Kansas,-9
2021-03-13,@Nebraska-Omaha,7,10,Kansas,-3
2021-03-19,@Nebraska-Omaha,6,1,South Dakota State,5
2021-03-19,@Nebraska-Omaha,7,1,South Dakota State,6
2021-03-20,@Nebraska-Omaha,6,7,South Dakota State,-1
2021-03-21,@Nebraska-Omaha,7,1,South Dakota State,6
2021-03-26,@Wichita State,5,14,Wichita State,-9
2021-03-27,@Wichita State,0,9,Wichita State,-9
2021-03-28,@Wichita State,1,11,Wichita State,-10
2021-04-02,@Nebraska-Omaha,2,8,North Dakota State,-6
2021-04-02,@Nebraska-Omaha,15,4,North Dakota State,11
2021-04-03,@Nebraska-Omaha,7,0,North Dakota State,7
2021-04-04,@Nebraska-Omaha,4,10,North Dakota State,-6
2021-04-10,@South Dakota State,10,5,South Dakota State,5
2021-04-10,@South Dakota State,2,1,South Dakota State,1
2021-04-11,@South Dakota State,0,6,South Dakota State,-6
2021-04-11,@South Dakota State,8,9,South Dakota State,-1
2021-04-15,@Nebraska-Omaha,2,1,Brigham Young,1
2021-04-16,@Nebraska-Omaha,6,5,Brigham Young,1
2021-04-17,@Nebraska-Omaha,4,1,Brigham Young,3
2021-04-30,@Nebraska-Omaha,11,1,Western Illinois,10
2021-05-01,@Nebraska-Omaha,12,2,Western Illinois,10
2021-05-02,@Nebraska-Omaha,15,13,Western Illinois,2
2021-05-07,@North Dakota State,0,2,North Dakota State,-2
2021-05-07,@North Dakota State,7,8,North Dakota State,-1
2021-05-08,@North Dakota State,7,8,North Dakota State,-1
2021-05-09,@North Dakota State,5,4,North Dakota State,1
2021-05-14,@Nebraska-Omaha,1,2,Oral Roberts,-1
2021-05-14,@Nebraska-Omaha,3,12,Oral Roberts,-9
2021-05-15,@Nebraska-Omaha,12,17,Oral Roberts,-5
2021-05-20,@Western Illinois,7,12,Western Illinois,-5
2021-05-20,@Western Illinois,7,1,Western Illinois,6
2021-05-21,@Western Illinois,13,0,Western Illinois,13
2021-05-22,@Western Illinois,8,6,Western Illinois,2
2021-05-27,@North Dakota State,1,3,North Dakota State,-2
2021-05-28,@Nebraska-Omaha,0,7,South Dakota State,-7
2021-02-19,@Cal Poly,0,4,Cal Poly,-4
2021-02-20,@Cal Poly,2,1,Cal Poly,1
2021-02-21,@Cal Poly,11,8,Cal Poly,3
2021-02-22,@Cal Poly,12,6,Cal Poly,6
2021-02-27,@Nevada-Las Vegas,3,8,Nevada-Las Vegas,-5
2021-02-27,@Nevada-Las Vegas,2,3,Nevada-Las Vegas,-1
2021-02-28,@Nevada-Las Vegas,6,1,Nevada-Las Vegas,5
2021-03-02,@Arizona State,4,13,Arizona State,-9
2021-03-12,@Southern California,1,3,Southern California,-2
2021-03-13,@Southern California,4,5,Southern California,-1
2021-03-14,@Southern California,2,7,Southern California,-5
2021-03-20,@Nevada,20,10,Fresno State,10
2021-03-20,@Nevada,7,6,Fresno State,1
2021-03-21,@Nevada,3,8,Fresno State,-5
2021-03-27,@New Mexico,9,7,New Mexico,2
2021-03-27,@New Mexico,5,6,New Mexico,-1
2021-03-28,@New Mexico,1,5,New Mexico,-4
2021-04-02,@Nevada,1,2,Air Force,-1
2021-04-02,@Nevada,5,7,Air Force,-2
2021-04-03,@Nevada,15,9,Air Force,6
2021-04-10,@San Diego State,10,6,San Diego State,4
2021-04-10,@San Diego State,7,15,San Diego State,-8
2021-04-11,@San Diego State,5,3,San Diego State,2
2021-04-13,@Texas,3,4,Texas,-1
2021-04-14,@Texas,5,6,Texas,-1
2021-04-24,@Air Force,14,7,Air Force,7
2021-04-24,@Air Force,3,6,Air Force,-3
2021-04-25,@Air Force,7,4,Air Force,3
2021-04-30,@Nevada,14,4,San Diego State,10
2021-04-30,@Nevada,13,2,San Diego State,11
2021-05-01,@Nevada,15,7,San Diego State,8
2021-05-08,@Nevada,6,5,Nevada-Las Vegas,1
2021-05-08,@Nevada,10,8,Nevada-Las Vegas,2
2021-05-09,@Nevada,8,3,Nevada-Las Vegas,5
2021-05-11,@Nevada,11,14,Arizona State,-3
2021-05-15,@Fresno State,14,2,Fresno State,12
2021-05-15,@Fresno State,9,6,Fresno State,3
2021-05-16,@Fresno State,3,1,Fresno State,2
2021-05-18,@UCLA,3,11,UCLA,-8
2021-05-28,@Nevada,16,6,San Jose State,10
2021-05-29,@Nevada,14,10,San Jose State,4
2021-05-29,@Nevada,7,2,San Jose State,5
2021-05-30,@Nevada,12,2,San Jose State,10
2021-06-04,@UC Irvine,0,7,UC Irvine,-7
2021-06-05,@North Dakota State,1,6,North Dakota State,-5
2021-02-27,@Nevada-Las Vegas,3,2,Nevada,1
2021-02-27,@Nevada-Las Vegas,8,3,Nevada,5
2021-02-28,@Nevada-Las Vegas,1,6,Nevada,-5
2021-03-06,@Nevada-Las Vegas,24,7,New Mexico,17
2021-03-06,@Nevada-Las Vegas,8,5,New Mexico,3
2021-03-07,@Nevada-Las Vegas,1,0,New Mexico,1
2021-03-13,@San Diego State,5,1,San Diego State,4
2021-03-13,@San Diego State,1,3,San Diego State,-2
2021-03-14,@San Diego State,6,8,San Diego State,-2
2021-03-16,@Arizona State,10,9,Arizona State,1
2021-03-23,@Nevada-Las Vegas,5,10,Washington State,-5
2021-03-24,@Nevada-Las Vegas,15,8,Washington State,7
2021-03-27,@Air Force,7,10,Air Force,-3
2021-03-27,@Air Force,3,4,Air Force,-1
2021-03-28,@Air Force,10,11,Air Force,-1
2021-04-02,@Nevada-Las Vegas,9,5,Fresno State,4
2021-04-02,@Nevada-Las Vegas,10,9,Fresno State,1
2021-04-03,@Nevada-Las Vegas,9,6,Fresno State,3
2021-04-08,@Nevada-Las Vegas,8,4,Pacific,4
2021-04-09,@Nevada-Las Vegas,3,2,Pacific,1
2021-04-10,@Nevada-Las Vegas,10,0,Pacific,10
2021-05-01,@Nevada-Las Vegas,12,9,Air Force,3
2021-05-01,@Nevada-Las Vegas,11,4,Air Force,7
2021-05-02,@Nevada-Las Vegas,6,8,Air Force,-2
2021-05-08,@Nevada,5,6,Nevada,-1
2021-05-08,@Nevada,8,10,Nevada,-2
2021-05-09,@Nevada,3,8,Nevada,-5
2021-05-15,@Nevada-Las Vegas,11,10,San Diego State,1
2021-05-15,@Nevada-Las Vegas,14,4,San Diego State,10
2021-05-16,@Nevada-Las Vegas,8,1,San Diego State,7
2021-05-22,@Fresno State,4,6,Fresno State,-2
2021-05-22,@Fresno State,13,2,Fresno State,11
2021-05-23,@Fresno State,2,12,Fresno State,-10
2021-02-25,@VMI,16,5,VMI,11
2021-02-25,@VMI,1,2,VMI,-1
2021-02-26,@VMI,7,8,VMI,-1
2021-03-06,@Fordham,3,5,Fordham,-2
2021-03-07,@Fordham,2,8,Fordham,-6
2021-03-07,@Fordham,4,5,Fordham,-1
2021-03-20,@New Jersey Tech,5,3,Albany,2
2021-03-20,@New Jersey Tech,2,3,Albany,-1
2021-03-21,@New Jersey Tech,4,5,Albany,-1
2021-03-21,@New Jersey Tech,2,4,Albany,-2
2021-03-26,@Hartford,5,4,Hartford,1
2021-03-26,@Hartford,4,8,Hartford,-4
2021-03-27,@Hartford,0,5,Hartford,-5
2021-03-27,@Hartford,6,8,Hartford,-2
2021-04-02,@Massachusetts-Lowell,1,8,Massachusetts-Lowell,-7
2021-04-02,@Massachusetts-Lowell,17,4,Massachusetts-Lowell,13
2021-04-03,@Massachusetts-Lowell,7,3,Massachusetts-Lowell,4
2021-04-03,@Massachusetts-Lowell,9,5,Massachusetts-Lowell,4
2021-04-09,@New Jersey Tech,10,9,Maine,1
2021-04-09,@New Jersey Tech,2,8,Maine,-6
2021-04-10,@New Jersey Tech,2,14,Maine,-12
2021-04-10,@New Jersey Tech,1,10,Maine,-9
2021-04-17,@Binghamton,0,2,Binghamton,-2
2021-04-17,@Binghamton,0,1,Binghamton,-1
2021-04-18,@Binghamton,2,1,Binghamton,1
2021-04-18,@Binghamton,3,6,Binghamton,-3
2021-04-24,@Stony Brook,3,2,Stony Brook,1
2021-04-24,@Stony Brook,6,5,Stony Brook,1
2021-04-25,@New Jersey Tech,2,5,Stony Brook,-3
2021-04-25,@New Jersey Tech,9,8,Stony Brook,1
2021-05-01,@Maryland-Baltimore County,17,4,Maryland-Baltimore County,13
2021-05-01,@Maryland-Baltimore County,10,7,Maryland-Baltimore County,3
2021-05-02,@Maryland-Baltimore County,7,5,Maryland-Baltimore County,2
2021-05-02,@Maryland-Baltimore County,14,6,Maryland-Baltimore County,8
2021-05-08,@Stony Brook,3,11,Stony Brook,-8
2021-05-08,@Stony Brook,2,0,Stony Brook,2
2021-05-09,@Stony Brook,7,5,Stony Brook,2
2021-05-09,@Stony Brook,3,4,Stony Brook,-1
2021-05-15,@New Jersey Tech,2,4,Binghamton,-2
2021-05-15,@New Jersey Tech,2,0,Binghamton,2
2021-05-16,@New Jersey Tech,6,2,Binghamton,4
2021-05-16,@New Jersey Tech,11,4,Binghamton,7
2021-05-21,@New Jersey Tech,7,1,Maryland-Baltimore County,6
2021-05-21,@New Jersey Tech,3,2,Maryland-Baltimore County,1
2021-05-22,@New Jersey Tech,13,6,Maryland-Baltimore County,7
2021-05-22,@New Jersey Tech,8,1,Maryland-Baltimore County,7
2021-05-27,@Albany,5,4,Albany,1
2021-05-28,@New Jersey Tech,2,1,Maine,1
2021-06-04,@Arkansas,8,13,Arkansas,-5
2021-06-05,@New Jersey Tech,3,2,Northeastern,1
2021-06-06,@Nebraska,4,18,Nebraska,-14
2021-02-19,@Gonzaga,3,4,Gonzaga,-1
2021-02-20,@Oregon State,1,14,Oregon State,-13
2021-02-21,@New Mexico,4,3,Kansas State,1
2021-02-22,@Oregon State,2,5,Oregon State,-3
2021-02-27,@New Mexico,11,7,Air Force,4
2021-02-27,@New Mexico,5,2,Air Force,3
2021-02-28,@New Mexico,11,4,Air Force,7
2021-03-06,@Nevada-Las Vegas,7,24,Nevada-Las Vegas,-17
2021-03-06,@Nevada-Las Vegas,5,8,Nevada-Las Vegas,-3
2021-03-07,@Nevada-Las Vegas,0,1,Nevada-Las Vegas,-1
2021-03-13,@Fresno State,1,0,Fresno State,1
2021-03-13,@Fresno State,2,5,Fresno State,-3
2021-03-14,@Fresno State,5,6,Fresno State,-1
2021-03-19,@Kansas State,1,7,Kansas State,-6
2021-03-20,@Kansas State,6,4,Kansas State,2
2021-03-21,@Kansas State,8,17,Kansas State,-9
2021-03-27,@New Mexico,7,9,Nevada,-2
2021-03-27,@New Mexico,6,5,Nevada,1
2021-03-28,@New Mexico,5,1,Nevada,4
2021-04-02,@San Diego State,4,5,San Diego State,-1
2021-04-02,@San Diego State,9,10,San Diego State,-1
2021-04-03,@San Diego State,0,15,San Diego State,-15
2021-04-23,@Washington,3,4,Washington,-1
2021-04-24,@Washington,5,3,Washington,2
2021-04-25,@Washington,2,3,Washington,-1
2021-04-28,@Texas Tech,4,10,Texas Tech,-6
2021-05-01,@New Mexico,9,11,Fresno State,-2
2021-05-01,@New Mexico,8,10,Fresno State,-2
2021-05-02,@New Mexico,9,12,Fresno State,-3
2021-05-08,@Air Force,12,15,Air Force,-3
2021-05-08,@Air Force,4,6,Air Force,-2
2021-05-09,@Air Force,3,10,Air Force,-7
2021-05-14,@New Mexico,9,4,Utah Valley,5
2021-05-15,@New Mexico,16,2,Utah Valley,14
2021-05-16,@New Mexico,14,6,Utah Valley,8
2021-05-22,@San Jose State,6,2,San Jose State,4
2021-05-22,@San Jose State,14,2,San Jose State,12
2021-05-23,@San Jose State,8,4,San Jose State,4
2021-05-28,@New Mexico,17,7,San Diego State,10
2021-05-28,@New Mexico,5,6,San Diego State,-1
2021-05-29,@New Mexico,10,11,San Diego State,-1
2021-02-26,@Abilene Christian,7,8,Abilene Christian,-1
2021-02-27,@Abilene Christian,9,15,Abilene Christian,-6
2021-02-28,@Abilene Christian,12,2,Abilene Christian,10
2021-03-02,@Texas State,6,8,Texas State,-2
2021-03-05,@Texas A&M,1,4,Texas A&M,-3
2021-03-06,@Texas A&M,0,5,Texas A&M,-5
2021-03-07,@Texas A&M,1,7,Texas A&M,-6
2021-03-12,@New Mexico State,17,3,Dixie State,14
2021-03-13,@New Mexico State,14,3,Dixie State,11
2021-03-13,@New Mexico State,19,2,Dixie State,17
2021-03-14,@New Mexico State,13,19,Dixie State,-6
2021-03-17,@New Mexico State,7,3,Benedictine (AZ),4
2021-03-19,@New Mexico State,13,7,Northern Colorado,6
2021-03-20,@New Mexico State,6,0,Northern Colorado,6
2021-03-20,@New Mexico State,15,8,Northern Colorado,7
2021-03-21,@New Mexico State,7,4,Northern Colorado,3
2021-03-26,@Seattle,1,2,Seattle,-1
2021-03-27,@Seattle,3,4,Seattle,-1
2021-03-27,@Seattle,2,1,Seattle,1
2021-03-29,@Seattle,1,6,Seattle,-5
2021-04-01,@Oregon,0,5,Oregon,-5
2021-04-02,@Oregon,2,8,Oregon,-6
2021-04-03,@Oregon,1,2,Oregon,-1
2021-04-03,@Oregon,1,6,Oregon,-5
2021-04-09,@Sacramento State,10,2,Sacramento State,8
2021-04-09,@Sacramento State,5,10,Sacramento State,-5
2021-04-10,@Sacramento State,6,9,Sacramento State,-3
2021-04-11,@Sacramento State,0,4,Sacramento State,-4
2021-04-16,@New Mexico State,4,5,Grand Canyon,-1
2021-04-17,@New Mexico State,1,3,Grand Canyon,-2
2021-04-17,@New Mexico State,2,4,Grand Canyon,-2
2021-04-18,@New Mexico State,3,11,Grand Canyon,-8
2021-04-20,@Arizona,4,11,Arizona,-7
2021-04-23,@Tarleton State,8,12,Tarleton State,-4
2021-04-24,@Tarleton State,1,4,Tarleton State,-3
2021-04-24,@Tarleton State,8,3,Tarleton State,5
2021-04-25,@Tarleton State,17,6,Tarleton State,11
2021-04-27,@New Mexico State,5,1,Benedictine (AZ),4
2021-04-30,@New Mexico State,5,8,Texas-Rio Grande Valley,-3
2021-05-01,@New Mexico State,12,8,Texas-Rio Grande Valley,4
2021-05-01,@New Mexico State,12,1,Texas-Rio Grande Valley,11
2021-05-02,@New Mexico State,11,10,Texas-Rio Grande Valley,1
2021-05-07,@Utah Valley,6,3,Utah Valley,3
2021-05-08,@Utah Valley,10,7,Utah Valley,3
2021-05-08,@Utah Valley,2,4,Utah Valley,-2
2021-05-09,@Utah Valley,5,7,Utah Valley,-2
2021-05-14,@New Mexico State,4,10,California Baptist,-6
2021-05-15,@New Mexico State,6,11,California Baptist,-5
2021-05-15,@New Mexico State,2,4,California Baptist,-2
2021-05-16,@New Mexico State,7,17,California Baptist,-10
2021-05-18,@Arizona,3,14,Arizona,-11
2021-05-26,@New Mexico State,7,5,Seattle,2
2021-05-27,@Grand Canyon,4,5,Grand Canyon,-1
2021-05-28,@New Mexico State,0,10,Seattle,-10
2021-02-20,@New Orleans,10,5,Southern,5
2021-02-21,@New Orleans,3,4,Southern,-1
2021-02-21,@New Orleans,6,3,Southern,3
2021-02-23,@Tulane,1,7,Tulane,-6
2021-02-26,@New Orleans,7,6,Louisiana-Monroe,1
2021-02-27,@New Orleans,7,4,Louisiana-Monroe,3
2021-02-28,@New Orleans,2,7,Louisiana-Monroe,-5
2021-03-03,@New Orleans,0,5,South Alabama,-5
2021-03-05,@New Orleans,5,0,Bradley,5
2021-03-06,@New Orleans,5,9,Bradley,-4
2021-03-07,@New Orleans,3,6,Bradley,-3
2021-03-10,@New Orleans,0,5,Louisiana State,-5
2021-03-12,@New Orleans,3,0,Houston Baptist,3
2021-03-13,@New Orleans,11,10,Houston Baptist,1
2021-03-13,@New Orleans,8,2,Houston Baptist,6
2021-03-14,@New Orleans,9,2,Houston Baptist,7
2021-03-19,@Stephen F. Austin State,6,4,Stephen F. Austin State,2
2021-03-20,@Stephen F. Austin State,4,5,Stephen F. Austin State,-1
2021-03-20,@Stephen F. Austin State,8,4,Stephen F. Austin State,4
2021-03-21,@Stephen F. Austin State,3,5,Stephen F. Austin State,-2
2021-03-26,@New Orleans,6,9,Abilene Christian,-3
2021-03-27,@New Orleans,8,4,Abilene Christian,4
2021-03-27,@New Orleans,10,19,Abilene Christian,-9
2021-03-28,@New Orleans,12,16,Abilene Christian,-4
2021-04-01,@Texas A&M-Corpus Christi,5,4,Texas A&M-Corpus Christi,1
2021-04-02,@Texas A&M-Corpus Christi,7,6,Texas A&M-Corpus Christi,1
2021-04-02,@Texas A&M-Corpus Christi,4,6,Texas A&M-Corpus Christi,-2
2021-04-03,@Texas A&M-Corpus Christi,6,4,Texas A&M-Corpus Christi,2
2021-04-09,@New Orleans,4,13,Sam Houston State,-9
2021-04-09,@New Orleans,9,7,Sam Houston State,2
2021-04-10,@New Orleans,20,13,Sam Houston State,7
2021-04-11,@New Orleans,1,7,Sam Houston State,-6
2021-04-16,@Incarnate Word,5,4,Incarnate Word,1
2021-04-17,@Incarnate Word,3,1,Incarnate Word,2
2021-04-17,@Incarnate Word,13,5,Incarnate Word,8
2021-04-18,@Incarnate Word,3,6,Incarnate Word,-3
2021-04-23,@New Orleans,9,8,Southeastern Louisiana,1
2021-04-24,@New Orleans,8,4,Southeastern Louisiana,4
2021-04-24,@New Orleans,11,3,Southeastern Louisiana,8
2021-04-25,@New Orleans,0,7,Southeastern Louisiana,-7
2021-04-30,@McNeese State,6,8,McNeese State,-2
2021-05-01,@McNeese State,3,8,McNeese State,-5
2021-05-01,@McNeese State,8,4,McNeese State,4
2021-05-02,@McNeese State,13,10,McNeese State,3
2021-05-07,@New Orleans,5,15,Central Arkansas,-10
2021-05-08,@New Orleans,11,0,Central Arkansas,11
2021-05-08,@New Orleans,0,8,Central Arkansas,-8
2021-05-09,@New Orleans,4,3,Central Arkansas,1
2021-05-14,@Lamar,0,6,Lamar,-6
2021-05-15,@Lamar,2,3,Lamar,-1
2021-05-15,@Lamar,2,0,Lamar,2
2021-05-16,@Lamar,4,6,Lamar,-2
2021-05-20,@Oklahoma State,6,9,Oklahoma State,-3
2021-05-21,@Oklahoma State,1,15,Oklahoma State,-14
2021-05-26,@New Orleans,0,12,McNeese State,-12
2021-05-27,@Northwestern State,14,1,Northwestern State,13
2021-05-28,@New Orleans,13,15,Southeastern Louisiana,-2
2021-03-20,@Rider,0,1,Rider,-1
2021-03-20,@Rider,5,11,Rider,-6
2021-03-21,@Rider,8,3,Rider,5
2021-03-21,@Rider,0,9,Rider,-9
2021-03-26,@Siena,4,11,Siena,-7
2021-03-26,@Siena,2,0,Siena,2
2021-03-27,@Siena,3,1,Siena,2
2021-03-27,@Siena,10,9,Siena,1
2021-04-02,@Niagara,8,7,Quinnipiac,1
2021-04-02,@Niagara,8,4,Quinnipiac,4
2021-04-03,@Niagara,4,3,Quinnipiac,1
2021-04-03,@Niagara,6,3,Quinnipiac,3
2021-04-07,@Niagara,4,3,Canisius,1
2021-04-07,@Niagara,3,6,Canisius,-3
2021-04-10,@St. Peter's,12,1,St. Peter's,11
2021-04-10,@St. Peter's,0,5,St. Peter's,-5
2021-04-11,@St. Peter's,9,0,St. Peter's,9
2021-04-11,@St. Peter's,13,4,St. Peter's,9
2021-04-14,@Niagara,3,2,Canisius,1
2021-04-14,@Niagara,2,20,Canisius,-18
2021-04-23,@Marist,3,6,Marist,-3
2021-04-23,@Marist,8,5,Marist,3
2021-04-24,@Marist,7,6,Marist,1
2021-04-24,@Marist,3,14,Marist,-11
2021-05-01,@Manhattan,10,6,Manhattan,4
2021-05-01,@Manhattan,4,5,Manhattan,-1
2021-05-02,@Manhattan,8,15,Manhattan,-7
2021-05-02,@Manhattan,8,5,Manhattan,3
2021-05-08,@Niagara,0,1,Fairfield,-1
2021-05-08,@Niagara,1,4,Fairfield,-3
2021-05-09,@Niagara,8,10,Fairfield,-2
2021-05-09,@Niagara,5,8,Fairfield,-3
2021-05-20,@Rider,4,12,Rider,-8
2021-05-20,@Rider,5,8,Rider,-3
2021-02-20,@Nicholls State,11,4,Eastern Illinois,7
2021-02-20,@Nicholls State,3,4,Eastern Illinois,-1
2021-02-21,@Nicholls State,2,3,Eastern Illinois,-1
2021-02-26,@Nicholls State,7,6,Youngstown State,1
2021-02-27,@Louisiana State,0,14,Louisiana State,-14
2021-02-28,@Nicholls State,4,7,Youngstown State,-3
2021-03-03,@Louisiana State,4,5,Louisiana State,-1
2021-03-06,@Louisiana-Monroe,5,2,Louisiana-Monroe,3
2021-03-06,@Louisiana-Monroe,3,5,Louisiana-Monroe,-2
2021-03-07,@Louisiana-Monroe,4,6,Louisiana-Monroe,-2
2021-03-12,@Nicholls State,8,6,Stephen F. Austin State,2
2021-03-13,@Nicholls State,2,1,Stephen F. Austin State,1
2021-03-13,@Nicholls State,3,2,Stephen F. Austin State,1
2021-03-14,@Nicholls State,2,1,Stephen F. Austin State,1
2021-03-16,@Nicholls State,8,9,Louisiana-Lafayette,-1
2021-03-19,@Abilene Christian,7,6,Abilene Christian,1
2021-03-20,@Abilene Christian,5,6,Abilene Christian,-1
2021-03-20,@Abilene Christian,1,4,Abilene Christian,-3
2021-03-21,@Abilene Christian,7,4,Abilene Christian,3
2021-03-26,@Nicholls State,4,5,Houston Baptist,-1
2021-03-27,@Nicholls State,5,4,Houston Baptist,1
2021-03-27,@Nicholls State,2,1,Houston Baptist,1
2021-03-28,@Nicholls State,2,6,Houston Baptist,-4
2021-04-01,@Nicholls State,2,1,Tennessee-Martin,1
2021-04-02,@Nicholls State,7,0,Tennessee-Martin,7
2021-04-03,@Nicholls State,0,2,Tennessee-Martin,-2
2021-04-06,@Louisiana-Lafayette,2,3,Louisiana-Lafayette,-1
2021-04-09,@Nicholls State,3,7,Texas A&M-Corpus Christi,-4
2021-04-09,@Nicholls State,1,5,Texas A&M-Corpus Christi,-4
2021-04-10,@Nicholls State,1,0,Texas A&M-Corpus Christi,1
2021-04-11,@Nicholls State,2,12,Texas A&M-Corpus Christi,-10
2021-04-17,@Lamar,2,11,Lamar,-9
2021-04-17,@Lamar,10,3,Lamar,7
2021-04-18,@Lamar,3,2,Lamar,1
2021-04-18,@Lamar,2,5,Lamar,-3
2021-04-24,@Northwestern State,6,13,Northwestern State,-7
2021-04-24,@Northwestern State,3,7,Northwestern State,-4
2021-04-25,@Northwestern State,1,2,Northwestern State,-1
2021-04-25,@Northwestern State,2,3,Northwestern State,-1
2021-04-30,@Nicholls State,2,1,Incarnate Word,1
2021-05-01,@Nicholls State,2,3,Incarnate Word,-1
2021-05-01,@Nicholls State,1,6,Incarnate Word,-5
2021-05-02,@Nicholls State,7,5,Incarnate Word,2
2021-05-07,@Southeastern Louisiana,11,3,Southeastern Louisiana,8
2021-05-08,@Southeastern Louisiana,6,7,Southeastern Louisiana,-1
2021-05-08,@Southeastern Louisiana,4,5,Southeastern Louisiana,-1
2021-05-09,@Nicholls State,4,2,Southeastern Louisiana,2
2021-05-14,@McNeese State,0,7,McNeese State,-7
2021-05-15,@McNeese State,7,10,McNeese State,-3
2021-05-15,@McNeese State,3,13,McNeese State,-10
2021-05-16,@McNeese State,5,6,McNeese State,-1
2021-05-21,@Nicholls State,3,16,Sam Houston State,-13
2021-05-21,@Nicholls State,4,11,Sam Houston State,-7
2021-05-22,@Nicholls State,5,4,Sam Houston State,1
2021-05-22,@Nicholls State,4,5,Sam Houston State,-1
2021-02-20,@Old Dominion,1,7,Old Dominion,-6
2021-02-21,@Old Dominion,0,12,Old Dominion,-12
2021-02-23,@Old Dominion,5,12,Old Dominion,-7
2021-02-24,@Old Dominion,2,19,Old Dominion,-17
2021-02-27,@North Carolina Central,0,7,North Carolina Central,-7
2021-02-27,@North Carolina Central,8,5,North Carolina Central,3
2021-02-28,@Norfolk State,10,5,North Carolina Central,5
2021-03-06,@Norfolk State,8,10,North Carolina Central,-2
2021-03-06,@Norfolk State,0,10,North Carolina Central,-10
2021-03-07,@North Carolina Central,6,7,North Carolina Central,-1
2021-03-09,@Norfolk State,4,7,Longwood,-3
2021-03-14,@Norfolk State,5,8,Longwood,-3
2021-03-14,@Norfolk State,2,1,Longwood,1
2021-03-20,@Norfolk State,3,5,Morehead State,-2
2021-03-20,@Norfolk State,1,5,Morehead State,-4
2021-03-21,@Norfolk State,2,10,Morehead State,-8
2021-03-21,@Norfolk State,4,2,Morehead State,2
2021-03-26,@Coppin State,12,13,Coppin State,-1
2021-03-26,@Coppin State,4,1,Coppin State,3
2021-03-27,@Coppin State,10,5,Coppin State,5
2021-03-27,@Coppin State,9,3,Coppin State,6
2021-03-30,@Richmond,5,17,Richmond,-12
2021-04-01,@Norfolk State,2,5,Delaware State,-3
2021-04-02,@Norfolk State,5,3,Delaware State,2
2021-04-02,@Norfolk State,7,2,Delaware State,5
2021-04-03,@Norfolk State,1,2,Delaware State,-1
2021-04-06,@Longwood,6,14,Longwood,-8
2021-04-10,@Florida A&M,2,6,Florida A&M,-4
2021-04-10,@Florida A&M,5,12,Florida A&M,-7
2021-04-11,@Florida A&M,6,2,Florida A&M,4
2021-04-11,@Florida A&M,7,4,Florida A&M,3
2021-04-16,@Norfolk State,5,3,Coppin State,2
2021-04-17,@Norfolk State,3,2,Coppin State,1
2021-04-17,@Norfolk State,6,2,Coppin State,4
2021-04-18,@Norfolk State,9,3,Coppin State,6
2021-04-23,@Delaware State,10,6,Delaware State,4
2021-04-23,@Delaware State,7,4,Delaware State,3
2021-04-24,@Delaware State,4,9,Delaware State,-5
2021-04-24,@Delaware State,3,2,Delaware State,1
2021-04-30,@Norfolk State,9,1,Florida A&M,8
2021-05-01,@Norfolk State,4,5,Florida A&M,-1
2021-05-01,@Norfolk State,4,12,Florida A&M,-8
2021-05-02,@Norfolk State,2,5,Florida A&M,-3
2021-05-11,@VMI,5,9,VMI,-4
2021-05-13,@Norfolk State,6,0,Delaware State,6
2021-05-14,@Norfolk State,8,7,Delaware State,1
2021-05-14,@Norfolk State,2,6,Delaware State,-4
2021-05-15,@Norfolk State,10,9,Delaware State,1
2021-05-20,@Norfolk State,8,3,Florida A&M,5
2021-05-21,@Norfolk State,1,0,North Carolina Central,1
2021-05-22,@Norfolk State,7,6,North Carolina Central,1
2021-06-04,@East Carolina,5,8,East Carolina,-3
2021-06-05,@Norfolk State,0,16,Maryland,-16
2021-02-23,@Belmont,1,5,Belmont,-4
2021-02-26,@Stetson,3,8,Stetson,-5
2021-02-27,@Stetson,0,6,Stetson,-6
2021-02-27,@Stetson,5,16,Stetson,-11
2021-02-28,@Stetson,2,7,Stetson,-5
2021-03-02,@Tennessee Tech,2,7,Tennessee Tech,-5
2021-03-05,@North Alabama,6,4,Arkansas-Little Rock,2
2021-03-06,@North Alabama,1,9,Arkansas-Little Rock,-8
2021-03-07,@North Alabama,3,10,Arkansas-Little Rock,-7
2021-03-09,@North Alabama,1,5,Tennessee-Martin,-4
2021-03-12,@Liberty,0,4,Liberty,-4
2021-03-13,@Liberty,0,7,Liberty,-7
2021-03-14,@Liberty,0,6,Liberty,-6
2021-03-16,@North Alabama,4,18,Tennessee Tech,-14
2021-03-19,@Bellarmine,4,9,Bellarmine,-5
2021-03-20,@Bellarmine,1,5,Bellarmine,-4
2021-03-21,@Bellarmine,3,6,Bellarmine,-3
2021-03-24,@Mississippi State,1,18,Mississippi State,-17
2021-03-26,@North Alabama,12,2,Lipscomb,10
2021-03-27,@North Alabama,7,6,Lipscomb,1
2021-03-28,@North Alabama,6,5,Lipscomb,1
2021-04-01,@Davidson,4,8,Davidson,-4
2021-04-02,@Davidson,4,6,Davidson,-2
2021-04-03,@Davidson,0,5,Davidson,-5
2021-04-05,@Mississippi,6,20,Mississippi,-14
2021-04-06,@Alabama State,3,10,Alabama State,-7
2021-04-09,@North Alabama,2,8,Kennesaw State,-6
2021-04-10,@North Alabama,3,11,Kennesaw State,-8
2021-04-11,@North Alabama,4,14,Kennesaw State,-10
2021-04-13,@North Alabama,8,10,Belmont,-2
2021-04-16,@North Alabama,5,13,Liberty,-8
2021-04-17,@North Alabama,1,15,Liberty,-14
2021-04-18,@North Alabama,0,15,Liberty,-15
2021-04-20,@Alabama,6,8,Alabama,-2
2021-04-23,@North Alabama,8,5,Bellarmine,3
2021-04-24,@North Alabama,4,7,Bellarmine,-3
2021-04-25,@North Alabama,2,3,Bellarmine,-1
2021-04-27,@Austin Peay State,15,16,Austin Peay State,-1
2021-04-30,@Lipscomb,6,3,Lipscomb,3
2021-05-01,@Lipscomb,5,3,Lipscomb,2
2021-05-02,@Lipscomb,5,14,Lipscomb,-9
2021-05-05,@North Alabama,6,7,Alabama State,-1
2021-05-07,@Louisiana-Lafayette,1,11,Louisiana-Lafayette,-10
2021-05-08,@Louisiana-Lafayette,2,5,Louisiana-Lafayette,-3
2021-05-09,@Louisiana-Lafayette,3,13,Louisiana-Lafayette,-10
2021-05-11,@Vanderbilt,2,3,Vanderbilt,-1
2021-05-18,@Auburn,6,14,Auburn,-8
2021-02-19,@North Carolina,8,1,James Madison,7
2021-02-20,@North Carolina,7,4,James Madison,3
2021-02-21,@North Carolina,3,2,James Madison,1
2021-02-23,@North Carolina,4,1,Elon,3
2021-02-25,@North Carolina,3,2,Virginia,1
2021-02-27,@North Carolina,2,1,Virginia,1
2021-02-28,@North Carolina,2,3,Virginia,-1
2021-03-05,@Virginia Tech,6,10,Virginia Tech,-4
2021-03-06,@Virginia Tech,4,6,Virginia Tech,-2
2021-03-07,@Virginia Tech,9,6,Virginia Tech,3
2021-03-09,@North Carolina,7,8,Liberty,-1
2021-03-12,@North Carolina,8,3,Clemson,5
2021-03-13,@North Carolina,5,4,Clemson,1
2021-03-14,@North Carolina,5,3,Clemson,2
2021-03-16,@Liberty,4,8,Liberty,-4
2021-03-19,@Boston College,9,3,Boston College,6
2021-03-20,@Boston College,3,10,Boston College,-7
2021-03-21,@Boston College,5,4,Boston College,1
2021-03-23,@North Carolina,8,1,East Carolina,7
2021-03-26,@North Carolina,2,9,North Carolina State,-7
2021-03-29,@North Carolina,1,6,North Carolina State,-5
2021-03-29,@North Carolina,3,8,North Carolina State,-5
2021-03-30,@East Carolina,10,11,East Carolina,-1
2021-04-02,@Florida State,4,3,Florida State,1
2021-04-03,@Florida State,2,4,Florida State,-2
2021-04-04,@Florida State,0,8,Florida State,-8
2021-04-06,@South Carolina,3,2,South Carolina,1
2021-04-10,@North Carolina,2,4,Duke,-2
2021-04-11,@North Carolina,11,5,Duke,6
2021-04-12,@North Carolina,21,8,Duke,13
2021-04-17,@Pittsburgh,2,3,Pittsburgh,-1
2021-04-17,@Pittsburgh,2,6,Pittsburgh,-4
2021-04-18,@Pittsburgh,10,9,Pittsburgh,1
2021-04-20,@North Carolina,3,6,Coastal Carolina,-3
2021-04-23,@North Carolina,6,5,"Miami, Florida",1
2021-04-23,@North Carolina,4,2,"Miami, Florida",2
2021-04-25,@North Carolina,1,8,"Miami, Florida",-7
2021-04-27,@North Carolina,1,4,North Carolina-Charlotte,-3
2021-04-30,@Notre Dame,0,4,Notre Dame,-4
2021-05-01,@Notre Dame,12,13,Notre Dame,-1
2021-05-02,@Notre Dame,5,19,Notre Dame,-14
2021-05-05,@North Carolina,9,3,Campbell,6
2021-05-11,@North Carolina,2,3,North Carolina-Greensboro,-1
2021-05-14,@North Carolina,5,1,Louisville,4
2021-05-15,@North Carolina,5,0,Louisville,5
2021-05-16,@North Carolina,10,5,Louisville,5
2021-05-18,@North Carolina,14,9,North Carolina-Wilmington,5
2021-05-20,@Georgia Tech,3,2,Georgia Tech,1
2021-05-21,@Georgia Tech,9,10,Georgia Tech,-1
2021-05-22,@Georgia Tech,6,10,Georgia Tech,-4
2021-05-25,@North Carolina,3,5,Pittsburgh,-2
2021-05-28,@North Carolina State,9,6,North Carolina State,3
2021-06-04,@UCLA,5,4,UCLA,1
2021-06-05,@North Carolina,2,7,Texas Tech,-5
2021-06-06,@North Carolina,2,12,UCLA,-10
2021-02-20,@College of Charleston,0,1,College of Charleston,-1
2021-02-21,@College of Charleston,4,3,College of Charleston,1
2021-02-21,@College of Charleston,2,14,College of Charleston,-12
2021-02-24,@Liberty,2,16,Liberty,-14
2021-02-27,@Appalachian State,2,6,Appalachian State,-4
2021-02-27,@Appalachian State,6,7,Appalachian State,-1
2021-02-28,@North Carolina A&T,11,3,Appalachian State,8
2021-03-02,@Appalachian State,7,14,Appalachian State,-7
2021-03-05,@The Citadel,7,6,The Citadel,1
2021-03-06,@The Citadel,6,7,The Citadel,-1
2021-03-07,@The Citadel,12,1,The Citadel,11
2021-03-09,@North Carolina A&T,0,23,North Carolina-Greensboro,-23
2021-03-12,@North Carolina A&T,8,7,Elon,1
2021-03-13,@North Carolina A&T,4,10,Elon,-6
2021-03-14,@Elon,9,10,Elon,-1
2021-03-16,@Appalachian State,5,14,Appalachian State,-9
2021-03-20,@North Carolina A&T,4,6,North Carolina Central,-2
2021-03-20,@North Carolina A&T,2,6,North Carolina Central,-4
2021-03-21,@North Carolina A&T,3,2,North Carolina Central,1
2021-03-21,@North Carolina A&T,8,2,North Carolina Central,6
2021-03-26,@Florida A&M,1,4,Florida A&M,-3
2021-03-27,@Florida A&M,3,4,Florida A&M,-1
2021-03-27,@Florida A&M,4,6,Florida A&M,-2
2021-03-28,@Florida A&M,7,12,Florida A&M,-5
2021-04-01,@Baylor,0,6,Baylor,-6
2021-04-02,@Baylor,1,7,Baylor,-6
2021-04-02,@Baylor,0,5,Baylor,-5
2021-04-03,@Baylor,3,7,Baylor,-4
2021-04-10,@North Carolina Central,1,4,North Carolina Central,-3
2021-04-10,@North Carolina Central,13,6,North Carolina Central,7
2021-04-11,@North Carolina Central,6,12,North Carolina Central,-6
2021-04-11,@North Carolina Central,12,7,North Carolina Central,5
2021-04-14,@North Carolina State,4,10,North Carolina State,-6
2021-04-16,@North Carolina A&T,8,2,Florida A&M,6
2021-04-17,@North Carolina A&T,10,5,Florida A&M,5
2021-04-17,@North Carolina A&T,5,13,Florida A&M,-8
2021-04-18,@North Carolina A&T,5,2,Florida A&M,3
2021-04-20,@North Carolina-Greensboro,2,8,North Carolina-Greensboro,-6
2021-04-23,@Coppin State,16,7,Coppin State,9
2021-04-23,@Coppin State,9,2,Coppin State,7
2021-04-24,@Coppin State,9,3,Coppin State,6
2021-04-24,@Coppin State,5,6,Coppin State,-1
2021-04-30,@North Carolina A&T,12,1,North Carolina Central,11
2021-05-01,@North Carolina A&T,2,11,North Carolina Central,-9
2021-05-01,@North Carolina A&T,2,5,North Carolina Central,-3
2021-05-02,@North Carolina A&T,9,4,North Carolina Central,5
2021-05-07,@Florida A&M,6,7,Florida A&M,-1
2021-05-08,@Florida A&M,3,5,Florida A&M,-2
2021-05-08,@Florida A&M,1,2,Florida A&M,-1
2021-05-09,@Florida A&M,11,9,Florida A&M,2
2021-05-13,@North Carolina A&T,6,5,Coppin State,1
2021-05-14,@North Carolina A&T,4,2,Coppin State,2
2021-05-14,@North Carolina A&T,8,0,Coppin State,8
2021-05-15,@North Carolina A&T,10,4,Coppin State,6
2021-02-19,@North Carolina Central,9,4,Army,5
2021-02-20,@North Carolina Central,8,1,Army,7
2021-02-21,@North Carolina Central,5,4,Army,1
2021-02-23,@Longwood,14,22,Longwood,-8
2021-02-27,@North Carolina Central,5,8,Norfolk State,-3
2021-02-27,@North Carolina Central,7,0,Norfolk State,7
2021-02-28,@Norfolk State,5,10,Norfolk State,-5
2021-03-06,@Norfolk State,10,0,Norfolk State,10
2021-03-06,@Norfolk State,10,8,Norfolk State,2
2021-03-07,@North Carolina Central,7,6,Norfolk State,1
2021-03-12,@North Carolina Central,3,14,East Tennessee State,-11
2021-03-13,@North Carolina Central,3,2,East Tennessee State,1
2021-03-13,@North Carolina Central,1,5,East Tennessee State,-4
2021-03-16,@Duke,4,7,Duke,-3
2021-03-20,@North Carolina A&T,6,2,North Carolina A&T,4
2021-03-20,@North Carolina A&T,6,4,North Carolina A&T,2
2021-03-21,@North Carolina A&T,2,8,North Carolina A&T,-6
2021-03-21,@North Carolina A&T,2,3,North Carolina A&T,-1
2021-04-06,@Duke,7,12,Duke,-5
2021-04-10,@North Carolina Central,6,13,North Carolina A&T,-7
2021-04-10,@North Carolina Central,4,1,North Carolina A&T,3
2021-04-11,@North Carolina Central,7,12,North Carolina A&T,-5
2021-04-11,@North Carolina Central,12,6,North Carolina A&T,6
2021-04-16,@Delaware State,3,8,Delaware State,-5
2021-04-17,@Delaware State,2,3,Delaware State,-1
2021-04-17,@Delaware State,9,3,Delaware State,6
2021-04-18,@Delaware State,6,0,Delaware State,6
2021-04-23,@Florida A&M,3,8,Florida A&M,-5
2021-04-23,@Florida A&M,3,0,Florida A&M,3
2021-04-25,@Florida A&M,2,4,Florida A&M,-2
2021-04-25,@Florida A&M,5,4,Florida A&M,1
2021-04-30,@North Carolina A&T,1,12,North Carolina A&T,-11
2021-05-01,@North Carolina A&T,5,2,North Carolina A&T,3
2021-05-01,@North Carolina A&T,11,2,North Carolina A&T,9
2021-05-02,@North Carolina A&T,4,9,North Carolina A&T,-5
2021-05-07,@North Carolina Central,10,0,Delaware State,10
2021-05-08,@North Carolina Central,2,3,Delaware State,-1
2021-05-08,@North Carolina Central,15,6,Delaware State,9
2021-05-09,@North Carolina Central,11,1,Delaware State,10
2021-05-13,@North Carolina Central,10,4,Florida A&M,6
2021-05-14,@North Carolina Central,5,0,Florida A&M,5
2021-05-14,@North Carolina Central,4,1,Florida A&M,3
2021-05-15,@North Carolina Central,6,1,Florida A&M,5
2021-05-20,@North Carolina Central,9,4,Delaware State,5
2021-05-21,@Norfolk State,0,1,Norfolk State,-1
2021-05-21,@North Carolina Central,5,3,Florida A&M,2
2021-05-22,@Norfolk State,6,7,Norfolk State,-1
2021-02-21,@North Carolina State,13,3,Davidson,10
2021-02-21,@North Carolina State,6,4,Davidson,2
2021-02-23,@North Carolina State,13,16,North Carolina-Greensboro,-3
2021-02-27,@North Carolina State,3,8,Georgia Tech,-5
2021-02-27,@North Carolina State,2,9,Georgia Tech,-7
2021-02-28,@North Carolina State,4,8,Georgia Tech,-4
2021-03-02,@North Carolina State,14,6,Campbell,8
2021-03-05,@North Carolina State,11,5,"Miami, Florida",6
2021-03-06,@North Carolina State,4,6,"Miami, Florida",-2
2021-03-07,@North Carolina State,4,6,"Miami, Florida",-2
2021-03-19,@North Carolina State,1,13,Louisville,-12
2021-03-20,@North Carolina State,3,6,Louisville,-3
2021-03-21,@North Carolina State,3,8,Louisville,-5
2021-03-23,@North Carolina-Wilmington,5,3,North Carolina-Wilmington,2
2021-03-26,@North Carolina,9,2,North Carolina,7
2021-03-29,@North Carolina,6,1,North Carolina,5
2021-03-29,@North Carolina,8,3,North Carolina,5
2021-03-30,@North Carolina-Greensboro,3,0,North Carolina-Greensboro,3
2021-04-02,@North Carolina State,6,10,Clemson,-4
2021-04-03,@North Carolina State,3,9,Clemson,-6
2021-04-04,@North Carolina State,9,5,Clemson,4
2021-04-06,@North Carolina State,13,2,Appalachian State,11
2021-04-09,@Boston College,20,5,Boston College,15
2021-04-10,@Boston College,5,4,Boston College,1
2021-04-11,@Boston College,7,0,Boston College,7
2021-04-14,@North Carolina State,10,4,North Carolina A&T,6
2021-04-16,@Notre Dame,2,3,Notre Dame,-1
2021-04-17,@Notre Dame,5,2,Notre Dame,3
2021-04-18,@Notre Dame,2,11,Notre Dame,-9
2021-04-23,@North Carolina State,3,1,Virginia Tech,2
2021-04-25,@North Carolina State,11,3,Virginia Tech,8
2021-04-25,@North Carolina State,7,6,Virginia Tech,1
2021-04-27,@Appalachian State,7,3,Appalachian State,4
2021-04-30,@Wake Forest,13,7,Wake Forest,6
2021-05-01,@Wake Forest,11,14,Wake Forest,-3
2021-05-02,@Wake Forest,15,8,Wake Forest,7
2021-05-11,@North Carolina State,9,1,North Carolina-Wilmington,8
2021-05-14,@Pittsburgh,3,2,Pittsburgh,1
2021-05-15,@Pittsburgh,9,7,Pittsburgh,2
2021-05-16,@Pittsburgh,10,3,Pittsburgh,7
2021-05-20,@North Carolina State,6,4,Florida State,2
2021-05-21,@North Carolina State,6,4,Florida State,2
2021-05-22,@North Carolina State,11,15,Florida State,-4
2021-05-27,@Pittsburgh,3,2,Pittsburgh,1
2021-05-28,@North Carolina State,6,9,North Carolina,-3
2021-05-29,@Georgia Tech,8,1,Georgia Tech,7
2021-05-30,@North Carolina State,0,1,Duke,-1
2021-06-04,@North Carolina State,8,1,Alabama,7
2021-06-05,@Louisiana Tech,8,3,Louisiana Tech,5
2021-06-06,@North Carolina State,14,7,Louisiana Tech,7
2021-06-11,@Arkansas,2,21,Arkansas,-19
2021-06-12,@North Carolina State,6,5,Arkansas,1
2021-06-13,@Arkansas,3,2,Arkansas,1
2021-06-19,@Stanford,10,4,Stanford,6
2021-06-21,@North Carolina State,1,0,Vanderbilt,1
2021-06-25,@North Carolina State,1,3,Vanderbilt,-2
2021-02-23,@Western Carolina,10,4,Western Carolina,6
2021-02-26,@East Tennessee State,1,9,East Tennessee State,-8
2021-02-27,@East Tennessee State,3,6,East Tennessee State,-3
2021-02-27,@East Tennessee State,2,6,East Tennessee State,-4
2021-03-02,@North Carolina-Asheville,9,10,Wofford,-1
2021-03-06,@High Point,2,8,High Point,-6
2021-03-06,@High Point,6,12,High Point,-6
2021-03-07,@High Point,10,11,High Point,-1
2021-03-12,@Charleston Southern,15,3,Charleston Southern,12
2021-03-13,@Charleston Southern,5,15,Charleston Southern,-10
2021-03-13,@Charleston Southern,1,9,Charleston Southern,-8
2021-03-17,@South Carolina-Upstate,1,4,South Carolina-Upstate,-3
2021-03-20,@North Carolina-Asheville,4,17,Campbell,-13
2021-03-20,@North Carolina-Asheville,8,6,Campbell,2
2021-03-21,@North Carolina-Asheville,4,2,Campbell,2
2021-03-23,@North Carolina-Asheville,3,6,Gardner-Webb,-3
2021-03-26,@North Carolina-Asheville,6,5,Radford,1
2021-03-26,@North Carolina-Asheville,6,11,Radford,-5
2021-03-27,@North Carolina-Asheville,5,2,Radford,3
2021-04-02,@North Carolina-Asheville,1,6,Presbyterian,-5
2021-04-03,@North Carolina-Asheville,8,5,Presbyterian,3
2021-04-03,@North Carolina-Asheville,7,6,Presbyterian,1
2021-04-06,@Presbyterian,4,5,Presbyterian,-1
2021-04-09,@Winthrop,11,3,Winthrop,8
2021-04-09,@Winthrop,12,7,Winthrop,5
2021-04-10,@Winthrop,8,10,Winthrop,-2
2021-04-16,@North Carolina-Wilmington,0,8,North Carolina-Wilmington,-8
2021-04-17,@North Carolina-Wilmington,2,3,North Carolina-Wilmington,-1
2021-04-18,@North Carolina-Wilmington,3,4,North Carolina-Wilmington,-1
2021-04-20,@Gardner-Webb,4,15,Gardner-Webb,-11
2021-04-22,@North Carolina-Asheville,1,13,Charleston Southern,-12
2021-04-23,@North Carolina-Asheville,4,2,Charleston Southern,2
2021-04-23,@North Carolina-Asheville,17,2,Charleston Southern,15
2021-04-27,@North Carolina-Asheville,6,2,Presbyterian,4
2021-04-30,@Campbell,1,19,Campbell,-18
2021-05-01,@Campbell,2,12,Campbell,-10
2021-05-01,@Campbell,1,9,Campbell,-8
2021-05-05,@Presbyterian,2,4,Presbyterian,-2
2021-05-07,@North Carolina-Asheville,3,2,Longwood,1
2021-05-07,@North Carolina-Asheville,11,10,Longwood,1
2021-05-08,@North Carolina-Asheville,3,5,Longwood,-2
2021-05-11,@North Carolina-Asheville,6,7,South Carolina-Upstate,-1
2021-05-14,@Gardner-Webb,6,7,Gardner-Webb,-1
2021-05-15,@Gardner-Webb,6,11,Gardner-Webb,-5
2021-05-15,@Gardner-Webb,7,8,Gardner-Webb,-1
2021-05-20,@North Carolina-Asheville,4,14,South Carolina-Upstate,-10
2021-05-21,@North Carolina-Asheville,3,4,South Carolina-Upstate,-1
2021-05-21,@North Carolina-Asheville,4,7,South Carolina-Upstate,-3
2021-02-19,@North Carolina-Charlotte,12,4,Morehead State,8
2021-02-20,@North Carolina-Charlotte,18,3,Morehead State,15
2021-02-21,@North Carolina-Charlotte,4,2,Morehead State,2
2021-02-27,@North Carolina-Charlotte,4,0,William and Mary,4
2021-02-27,@North Carolina-Charlotte,7,1,William and Mary,6
2021-02-28,@North Carolina-Charlotte,20,4,William and Mary,16
2021-03-02,@North Carolina-Greensboro,7,9,North Carolina-Greensboro,-2
2021-03-05,@North Carolina-Charlotte,7,4,Western Carolina,3
2021-03-06,@North Carolina-Charlotte,2,5,Western Carolina,-3
2021-03-07,@North Carolina-Charlotte,5,10,Western Carolina,-5
2021-03-09,@North Carolina-Charlotte,9,0,Tennessee,9
2021-03-12,@East Carolina,4,7,East Carolina,-3
2021-03-13,@East Carolina,1,3,East Carolina,-2
2021-03-14,@East Carolina,1,3,East Carolina,-2
2021-03-16,@Wake Forest,1,4,Wake Forest,-3
2021-03-20,@North Carolina-Charlotte,3,6,Rhode Island,-3
2021-03-20,@North Carolina-Charlotte,2,1,Rhode Island,1
2021-03-21,@North Carolina-Charlotte,6,3,Rhode Island,3
2021-03-23,@North Carolina-Charlotte,15,5,Appalachian State,10
2021-03-26,@Western Kentucky,7,4,Western Kentucky,3
2021-03-27,@Western Kentucky,5,4,Western Kentucky,1
2021-03-27,@Western Kentucky,6,0,Western Kentucky,6
2021-03-28,@Western Kentucky,16,17,Western Kentucky,-1
2021-04-02,@North Carolina-Charlotte,9,5,Florida Atlantic,4
2021-04-03,@North Carolina-Charlotte,9,8,Florida Atlantic,1
2021-04-03,@North Carolina-Charlotte,5,4,Florida Atlantic,1
2021-04-04,@North Carolina-Charlotte,11,10,Florida Atlantic,1
2021-04-09,@Florida International,11,8,Florida International,3
2021-04-10,@Florida International,5,4,Florida International,1
2021-04-10,@Florida International,3,1,Florida International,2
2021-04-11,@Florida International,9,5,Florida International,4
2021-04-16,@North Carolina-Charlotte,6,2,Texas-San Antonio,4
2021-04-17,@North Carolina-Charlotte,11,10,Texas-San Antonio,1
2021-04-17,@North Carolina-Charlotte,10,6,Texas-San Antonio,4
2021-04-18,@North Carolina-Charlotte,5,11,Texas-San Antonio,-6
2021-04-20,@Appalachian State,11,8,Appalachian State,3
2021-04-23,@North Carolina-Charlotte,5,9,Old Dominion,-4
2021-04-23,@North Carolina-Charlotte,5,4,Old Dominion,1
2021-04-25,@North Carolina-Charlotte,8,3,Old Dominion,5
2021-04-25,@North Carolina-Charlotte,7,1,Old Dominion,6
2021-04-27,@North Carolina,4,1,North Carolina,3
2021-04-30,@Old Dominion,3,8,Old Dominion,-5
2021-05-01,@Old Dominion,2,14,Old Dominion,-12
2021-05-01,@Old Dominion,6,2,Old Dominion,4
2021-05-02,@Old Dominion,0,10,Old Dominion,-10
2021-05-07,@North Carolina-Charlotte,7,5,Marshall,2
2021-05-08,@North Carolina-Charlotte,12,3,Marshall,9
2021-05-08,@North Carolina-Charlotte,10,8,Marshall,2
2021-05-09,@North Carolina-Charlotte,6,3,Marshall,3
2021-05-14,@Rice,9,6,Rice,3
2021-05-15,@Rice,6,4,Rice,2
2021-05-15,@Rice,8,11,Rice,-3
2021-05-16,@Rice,0,6,Rice,-6
2021-05-20,@North Carolina-Charlotte,2,6,North Carolina-Wilmington,-4
2021-05-21,@North Carolina-Charlotte,6,5,North Carolina-Wilmington,1
2021-05-22,@North Carolina-Charlotte,15,14,North Carolina-Wilmington,1
2021-05-26,@North Carolina-Charlotte,2,7,Middle Tennessee State,-5
2021-05-27,@North Carolina-Charlotte,8,9,Florida Atlantic,-1
2021-06-04,@North Carolina-Charlotte,13,10,Maryland,3
2021-06-05,@East Carolina,5,7,East Carolina,-2
2021-06-06,@Maryland,1,2,Maryland,-1
2021-02-19,@North Carolina-Greensboro,4,7,Elon,-3
2021-02-20,@North Carolina-Greensboro,8,3,Elon,5
2021-02-21,@North Carolina-Greensboro,3,2,Elon,1
2021-02-23,@North Carolina State,16,13,North Carolina State,3
2021-02-27,@High Point,4,2,High Point,2
2021-02-28,@North Carolina-Greensboro,6,5,High Point,1
2021-02-28,@North Carolina-Greensboro,3,4,High Point,-1
2021-03-02,@North Carolina-Greensboro,9,7,North Carolina-Charlotte,2
2021-03-05,@Elon,7,3,Elon,4
2021-03-06,@North Carolina-Greensboro,9,3,Elon,6
2021-03-07,@Elon,14,6,Elon,8
2021-03-09,@North Carolina A&T,23,0,North Carolina A&T,23
2021-03-12,@Tennessee,2,6,Tennessee,-4
2021-03-13,@Tennessee,9,14,Tennessee,-5
2021-03-14,@Tennessee,3,9,Tennessee,-6
2021-03-16,@Virginia Tech,7,2,Virginia Tech,5
2021-03-20,@North Carolina-Greensboro,1,6,Samford,-5
2021-03-20,@North Carolina-Greensboro,5,12,Samford,-7
2021-03-21,@North Carolina-Greensboro,3,8,Samford,-5
2021-03-23,@Duke,2,5,Duke,-3
2021-03-26,@VMI,5,6,VMI,-1
2021-03-27,@VMI,13,2,VMI,11
2021-03-27,@VMI,11,3,VMI,8
2021-03-30,@North Carolina-Greensboro,0,3,North Carolina State,-3
2021-04-02,@North Carolina-Greensboro,9,2,East Tennessee State,7
2021-04-03,@North Carolina-Greensboro,3,6,East Tennessee State,-3
2021-04-03,@North Carolina-Greensboro,1,4,East Tennessee State,-3
2021-04-10,@Mercer,4,7,Mercer,-3
2021-04-11,@Mercer,3,7,Mercer,-4
2021-04-11,@Mercer,0,17,Mercer,-17
2021-04-14,@Gardner-Webb,9,0,Gardner-Webb,9
2021-04-16,@Wofford,12,13,Wofford,-1
2021-04-17,@Wofford,0,5,Wofford,-5
2021-04-17,@Wofford,10,11,Wofford,-1
2021-04-20,@North Carolina-Greensboro,8,2,North Carolina A&T,6
2021-04-23,@North Carolina-Greensboro,9,7,The Citadel,2
2021-04-23,@North Carolina-Greensboro,4,2,The Citadel,2
2021-04-24,@North Carolina-Greensboro,14,1,The Citadel,13
2021-04-27,@High Point,12,3,High Point,9
2021-04-30,@North Carolina-Greensboro,17,8,Western Carolina,9
2021-05-01,@North Carolina-Greensboro,1,7,Western Carolina,-6
2021-05-01,@North Carolina-Greensboro,6,4,Western Carolina,2
2021-05-07,@East Tennessee State,1,5,East Tennessee State,-4
2021-05-08,@East Tennessee State,13,5,East Tennessee State,8
2021-05-08,@East Tennessee State,9,6,East Tennessee State,3
2021-05-11,@North Carolina,3,2,North Carolina,1
2021-05-14,@Samford,3,8,Samford,-5
2021-05-14,@Samford,11,4,Samford,7
2021-05-15,@Samford,4,8,Samford,-4
2021-05-20,@North Carolina-Greensboro,7,5,VMI,2
2021-05-21,@North Carolina-Greensboro,2,3,VMI,-1
2021-05-21,@North Carolina-Greensboro,4,8,VMI,-4
2021-02-20,@North Carolina-Wilmington,5,4,Virginia Commonwealth,1
2021-02-21,@North Carolina-Wilmington,4,1,Virginia Commonwealth,3
2021-02-21,@North Carolina-Wilmington,9,5,Virginia Commonwealth,4
2021-02-26,@North Carolina-Wilmington,2,8,Western Carolina,-6
2021-02-27,@North Carolina-Wilmington,8,6,Western Carolina,2
2021-02-28,@North Carolina-Wilmington,10,6,Western Carolina,4
2021-03-04,@North Carolina-Wilmington,14,10,Cincinnati,4
2021-03-05,@North Carolina-Wilmington,4,7,Cincinnati,-3
2021-03-06,@North Carolina-Wilmington,4,5,Cincinnati,-1
2021-03-07,@North Carolina-Wilmington,9,8,Cincinnati,1
2021-03-12,@North Carolina-Wilmington,6,1,Appalachian State,5
2021-03-13,@North Carolina-Wilmington,4,1,Appalachian State,3
2021-03-14,@North Carolina-Wilmington,7,1,Appalachian State,6
2021-03-17,@North Carolina-Wilmington,10,2,East Carolina,8
2021-03-20,@William and Mary,4,5,William and Mary,-1
2021-03-20,@William and Mary,6,7,William and Mary,-1
2021-03-21,@William and Mary,4,1,William and Mary,3
2021-03-23,@North Carolina-Wilmington,3,5,North Carolina State,-2
2021-03-26,@College of Charleston,6,1,College of Charleston,5
2021-03-27,@College of Charleston,8,11,College of Charleston,-3
2021-03-28,@College of Charleston,9,10,College of Charleston,-1
2021-04-02,@North Carolina-Wilmington,6,4,Elon,2
2021-04-03,@North Carolina-Wilmington,4,5,Elon,-1
2021-04-04,@North Carolina-Wilmington,8,2,Elon,6
2021-04-10,@Oklahoma State,6,7,Oklahoma State,-1
2021-04-10,@Oklahoma State,3,10,Oklahoma State,-7
2021-04-11,@Oklahoma State,4,10,Oklahoma State,-6
2021-04-14,@North Carolina-Wilmington,2,8,Coastal Carolina,-6
2021-04-16,@North Carolina-Wilmington,8,0,North Carolina-Asheville,8
2021-04-17,@North Carolina-Wilmington,3,2,North Carolina-Asheville,1
2021-04-18,@North Carolina-Wilmington,4,3,North Carolina-Asheville,1
2021-04-23,@Elon,1,2,Elon,-1
2021-04-25,@Elon,6,7,Elon,-1
2021-04-25,@Elon,6,5,Elon,1
2021-04-27,@Coastal Carolina,11,1,Coastal Carolina,10
2021-04-28,@North Carolina-Wilmington,7,6,Coastal Carolina,1
2021-04-30,@North Carolina-Wilmington,3,5,William and Mary,-2
2021-05-01,@North Carolina-Wilmington,11,0,William and Mary,11
2021-05-02,@North Carolina-Wilmington,1,0,William and Mary,1
2021-05-07,@North Carolina-Wilmington,5,3,James Madison,2
2021-05-08,@North Carolina-Wilmington,12,5,James Madison,7
2021-05-09,@North Carolina-Wilmington,5,1,James Madison,4
2021-05-11,@North Carolina State,1,9,North Carolina State,-8
2021-05-14,@North Carolina-Wilmington,7,2,College of Charleston,5
2021-05-15,@North Carolina-Wilmington,7,6,College of Charleston,1
2021-05-16,@North Carolina-Wilmington,8,4,College of Charleston,4
2021-05-18,@North Carolina,9,14,North Carolina,-5
2021-05-20,@North Carolina-Charlotte,6,2,North Carolina-Charlotte,4
2021-05-21,@North Carolina-Charlotte,5,6,North Carolina-Charlotte,-1
2021-05-22,@North Carolina-Charlotte,14,15,North Carolina-Charlotte,-1
2021-05-27,@North Carolina-Wilmington,2,0,Elon,2
2021-05-28,@Northeastern,8,4,Northeastern,4
2021-05-29,@North Carolina-Wilmington,5,7,Northeastern,-2
2021-05-30,@Northeastern,10,11,Northeastern,-1
2021-02-21,@Western Kentucky,4,10,Western Kentucky,-6
2021-02-22,@Western Kentucky,10,2,Western Kentucky,8
2021-02-22,@Western Kentucky,8,5,Western Kentucky,3
2021-02-26,@St. Louis,7,4,St. Louis,3
2021-02-27,@St. Louis,5,4,St. Louis,1
2021-02-27,@St. Louis,6,5,St. Louis,1
2021-03-05,@Northern Colorado,4,8,Northern Colorado,-4
2021-03-06,@Northern Colorado,4,14,Northern Colorado,-10
2021-03-06,@Northern Colorado,11,1,Northern Colorado,10
2021-03-07,@Northern Colorado,11,1,Northern Colorado,10
2021-03-12,@Dayton,5,1,Dayton,4
2021-03-13,@Dayton,9,1,Dayton,8
2021-03-14,@Dayton,4,3,Dayton,1
2021-03-16,@Dayton,9,3,Dayton,6
2021-03-19,@Western Illinois,11,2,Western Illinois,9
2021-03-20,@Western Illinois,7,3,Western Illinois,4
2021-03-20,@Western Illinois,8,4,Western Illinois,4
2021-03-21,@Western Illinois,7,9,Western Illinois,-2
2021-03-26,@Oral Roberts,4,5,Oral Roberts,-1
2021-03-26,@Oral Roberts,6,3,Oral Roberts,3
2021-03-27,@Oral Roberts,3,5,Oral Roberts,-2
2021-03-28,@Oral Roberts,9,7,Oral Roberts,2
2021-04-02,@Nebraska-Omaha,8,2,Nebraska-Omaha,6
2021-04-02,@Nebraska-Omaha,4,15,Nebraska-Omaha,-11
2021-04-03,@Nebraska-Omaha,0,7,Nebraska-Omaha,-7
2021-04-04,@Nebraska-Omaha,10,4,Nebraska-Omaha,6
2021-04-09,@North Dakota State,2,0,Western Illinois,2
2021-04-10,@North Dakota State,6,3,Western Illinois,3
2021-04-10,@North Dakota State,10,7,Western Illinois,3
2021-04-11,@North Dakota State,6,5,Western Illinois,1
2021-04-16,@North Dakota State,6,8,Oral Roberts,-2
2021-04-17,@North Dakota State,2,18,Oral Roberts,-16
2021-04-17,@North Dakota State,14,11,Oral Roberts,3
2021-04-23,@South Dakota State,2,3,South Dakota State,-1
2021-04-23,@South Dakota State,5,0,South Dakota State,5
2021-04-24,@South Dakota State,2,12,South Dakota State,-10
2021-04-24,@South Dakota State,13,12,South Dakota State,1
2021-04-27,@North Dakota State,5,3,Valley City State,2
2021-04-30,@Kansas,5,3,Kansas,2
2021-05-01,@Kansas,2,10,Kansas,-8
2021-05-02,@Kansas,5,3,Kansas,2
2021-05-04,@North Dakota State,6,2,Mayville State,4
2021-05-07,@North Dakota State,8,7,Nebraska-Omaha,1
2021-05-07,@North Dakota State,2,0,Nebraska-Omaha,2
2021-05-08,@North Dakota State,8,7,Nebraska-Omaha,1
2021-05-09,@North Dakota State,4,5,Nebraska-Omaha,-1
2021-05-10,@North Dakota State,8,7,Concordia Moorhead,1
2021-05-14,@North Dakota State,7,4,South Dakota State,3
2021-05-14,@North Dakota State,0,5,South Dakota State,-5
2021-05-15,@North Dakota State,5,3,South Dakota State,2
2021-05-16,@North Dakota State,10,4,South Dakota State,6
2021-05-20,@Eastern Kentucky,3,15,Eastern Kentucky,-12
2021-05-21,@Eastern Kentucky,8,1,Eastern Kentucky,7
2021-05-22,@Eastern Kentucky,6,1,Eastern Kentucky,5
2021-05-27,@North Dakota State,3,1,Nebraska-Omaha,2
2021-05-28,@Oral Roberts,5,0,Oral Roberts,5
2021-05-29,@North Dakota State,5,15,Oral Roberts,-10
2021-05-29,@Oral Roberts,11,6,Oral Roberts,5
2021-06-04,@Stanford,1,9,Stanford,-8
2021-06-05,@North Dakota State,6,1,Nevada,5
2021-06-06,@North Dakota State,3,18,UC Irvine,-15
2021-02-20,@Florida State,7,4,Florida State,3
2021-02-21,@Florida State,4,8,Florida State,-4
2021-02-21,@Florida State,7,14,Florida State,-7
2021-02-23,@North Florida,6,9,Florida,-3
2021-02-24,@Florida,3,8,Florida,-5
2021-02-26,@The Citadel,4,8,The Citadel,-4
2021-02-27,@The Citadel,13,6,The Citadel,7
2021-02-27,@The Citadel,3,2,The Citadel,1
2021-03-03,@North Florida,1,3,Georgia Southern,-2
2021-03-05,@Georgia,7,4,Georgia,3
2021-03-06,@Georgia,0,6,Georgia,-6
2021-03-07,@Georgia,4,7,Georgia,-3
2021-03-10,@North Florida,0,10,Central Florida,-10
2021-03-12,@Central Florida,2,6,Central Florida,-4
2021-03-13,@North Florida,14,7,Central Florida,7
2021-03-14,@Central Florida,2,3,Central Florida,-1
2021-03-23,@South Florida,3,2,South Florida,1
2021-03-26,@Jacksonville,5,3,Jacksonville,2
2021-03-27,@Jacksonville,13,6,Jacksonville,7
2021-03-28,@Jacksonville,9,3,Jacksonville,6
2021-04-01,@North Florida,11,12,Florida Gulf Coast,-1
2021-04-02,@North Florida,5,6,Florida Gulf Coast,-1
2021-04-03,@North Florida,5,7,Florida Gulf Coast,-2
2021-04-13,@Georgia Southern,6,8,Georgia Southern,-2
2021-04-16,@Stetson,7,3,Stetson,4
2021-04-17,@Stetson,4,16,Stetson,-12
2021-04-18,@Stetson,7,1,Stetson,6
2021-04-23,@North Florida,8,5,Jacksonville,3
2021-04-24,@North Florida,10,4,Jacksonville,6
2021-04-25,@North Florida,14,6,Jacksonville,8
2021-04-28,@North Florida,16,6,Florida A&M,10
2021-04-30,@Florida Gulf Coast,1,10,Florida Gulf Coast,-9
2021-05-01,@Florida Gulf Coast,1,11,Florida Gulf Coast,-10
2021-05-02,@Florida Gulf Coast,7,3,Florida Gulf Coast,4
2021-05-05,@South Carolina,6,7,South Carolina,-1
2021-05-07,@North Florida,6,5,Stetson,1
2021-05-08,@North Florida,5,3,Stetson,2
2021-05-09,@North Florida,4,5,Stetson,-1
2021-05-14,@Jacksonville,2,12,Jacksonville,-10
2021-05-16,@North Florida,3,2,Stetson,1
2021-05-21,@North Florida,5,4,Stetson,1
2021-05-22,@North Florida,9,2,Stetson,7
2021-05-27,@North Florida,6,5,Kennesaw State,1
2021-05-28,@North Florida,5,8,Jacksonville,-3
2021-05-28,@Liberty,2,5,Liberty,-3
2021-02-19,@Wake Forest,6,8,Wake Forest,-2
2021-02-20,@Wake Forest,0,9,Wake Forest,-9
2021-02-21,@Wake Forest,14,11,Wake Forest,3
2021-03-03,@Northeastern,11,2,Massachusetts,9
2021-03-05,@Old Dominion,8,10,Old Dominion,-2
2021-03-06,@Old Dominion,6,5,Old Dominion,1
2021-03-07,@Old Dominion,2,3,Old Dominion,-1
2021-03-09,@Northeastern,10,1,Albany,9
2021-03-12,@Northeastern,2,0,Massachusetts-Lowell,2
2021-03-12,@Northeastern,7,10,Massachusetts-Lowell,-3
2021-03-13,@Northeastern,2,1,Massachusetts-Lowell,1
2021-03-16,@Northeastern,5,0,Bryant,5
2021-03-26,@Northeastern,18,1,Massachusetts,17
2021-03-27,@Northeastern,4,3,Massachusetts,1
2021-03-27,@Northeastern,5,2,Massachusetts,3
2021-04-06,@Northeastern,3,5,Boston College,-2
2021-04-07,@Massachusetts,11,1,Massachusetts,10
2021-04-09,@Hofstra,8,2,Hofstra,6
2021-04-10,@Hofstra,13,5,Hofstra,8
2021-04-10,@Hofstra,3,2,Hofstra,1
2021-04-20,@Northeastern,12,5,Merrimack,7
2021-04-23,@Northeastern,6,5,Delaware,1
2021-04-23,@Northeastern,1,0,Delaware,1
2021-04-24,@Northeastern,9,4,Delaware,5
2021-04-24,@Northeastern,3,1,Delaware,2
2021-04-30,@Northeastern,3,0,Towson,3
2021-05-01,@Northeastern,7,4,Towson,3
2021-05-01,@Northeastern,2,1,Towson,1
2021-05-02,@Northeastern,3,1,Towson,2
2021-05-07,@Northeastern,13,1,Hofstra,12
2021-05-08,@Northeastern,14,8,Hofstra,6
2021-05-08,@Northeastern,5,3,Hofstra,2
2021-05-09,@Northeastern,11,0,Hofstra,11
2021-05-12,@Hofstra,10,3,Hofstra,7
2021-05-14,@Delaware,8,1,Delaware,7
2021-05-15,@Delaware,3,5,Delaware,-2
2021-05-15,@Delaware,26,4,Delaware,22
2021-05-16,@Delaware,7,9,Delaware,-2
2021-05-20,@Towson,15,2,Towson,13
2021-05-21,@Towson,1,2,Towson,-1
2021-05-22,@Towson,5,0,Towson,5
2021-05-27,@Northeastern,10,3,College of Charleston,7
2021-05-28,@Northeastern,4,8,North Carolina-Wilmington,-4
2021-05-29,@North Carolina-Wilmington,7,5,North Carolina-Wilmington,2
2021-05-29,@College of Charleston,5,1,College of Charleston,4
2021-05-30,@Northeastern,11,10,North Carolina-Wilmington,1
2021-06-04,@Nebraska,6,8,Nebraska,-2
2021-06-05,@New Jersey Tech,2,3,New Jersey Tech,-1
2021-02-20,@Colorado Christian,5,1,Colorado Christian,4
2021-02-20,@Colorado Christian,8,9,Colorado Christian,-1
2021-02-21,@Colorado Christian,17,10,Colorado Christian,7
2021-02-26,@Northern Colorado,0,12,South Dakota State,-12
2021-02-27,@Northern Colorado,2,6,South Dakota State,-4
2021-02-28,@Northern Colorado,9,12,South Dakota State,-3
2021-02-28,@Northern Colorado,3,6,South Dakota State,-3
2021-03-05,@Northern Colorado,8,4,North Dakota State,4
2021-03-06,@Northern Colorado,1,11,North Dakota State,-10
2021-03-06,@Northern Colorado,14,4,North Dakota State,10
2021-03-07,@Northern Colorado,1,11,North Dakota State,-10
2021-03-13,@California Baptist,3,4,California Baptist,-1
2021-03-13,@California Baptist,3,7,California Baptist,-4
2021-03-14,@California Baptist,4,7,California Baptist,-3
2021-03-14,@California Baptist,1,2,California Baptist,-1
2021-03-19,@New Mexico State,7,13,New Mexico State,-6
2021-03-20,@New Mexico State,0,6,New Mexico State,-6
2021-03-20,@New Mexico State,8,15,New Mexico State,-7
2021-03-21,@New Mexico State,4,7,New Mexico State,-3
2021-03-26,@Northern Colorado,10,0,Utah Valley,10
2021-03-27,@Northern Colorado,8,1,Utah Valley,7
2021-03-27,@Northern Colorado,3,7,Utah Valley,-4
2021-03-28,@Northern Colorado,6,7,Utah Valley,-1
2021-04-09,@Grand Canyon,4,2,Grand Canyon,2
2021-04-10,@Grand Canyon,0,4,Grand Canyon,-4
2021-04-10,@Grand Canyon,0,5,Grand Canyon,-5
2021-04-11,@Grand Canyon,3,10,Grand Canyon,-7
2021-04-13,@Kansas State,2,8,Kansas State,-6
2021-04-14,@Kansas State,3,10,Kansas State,-7
2021-04-23,@Northern Colorado,2,4,Sacramento State,-2
2021-04-24,@Northern Colorado,8,6,Sacramento State,2
2021-04-24,@Northern Colorado,1,10,Sacramento State,-9
2021-04-25,@Northern Colorado,13,11,Sacramento State,2
2021-04-30,@Northern Colorado,15,9,Tarleton State,6
2021-05-01,@Northern Colorado,4,11,Tarleton State,-7
2021-05-01,@Northern Colorado,6,5,Tarleton State,1
2021-05-02,@Northern Colorado,5,21,Tarleton State,-16
2021-05-08,@Utah,5,8,Utah,-3
2021-05-09,@Utah,7,11,Utah,-4
2021-05-10,@Utah,3,12,Utah,-9
2021-05-14,@Texas-Rio Grande Valley,0,10,Texas-Rio Grande Valley,-10
2021-05-14,@Texas-Rio Grande Valley,0,5,Texas-Rio Grande Valley,-5
2021-05-16,@Texas-Rio Grande Valley,2,15,Texas-Rio Grande Valley,-13
2021-05-20,@Dixie State,3,6,Dixie State,-3
2021-05-21,@Dixie State,3,6,Dixie State,-3
2021-05-21,@Dixie State,2,11,Dixie State,-9
2021-05-22,@Dixie State,6,9,Dixie State,-3
2021-02-26,@Evansville,4,5,Evansville,-1
2021-02-27,@Evansville,5,8,Evansville,-3
2021-02-28,@Evansville,7,4,Evansville,3
2021-03-05,@Texas-Rio Grande Valley,1,11,Texas-Rio Grande Valley,-10
2021-03-06,@Texas-Rio Grande Valley,2,15,Texas-Rio Grande Valley,-13
2021-03-07,@Texas-Rio Grande Valley,4,5,Texas-Rio Grande Valley,-1
2021-03-07,@Texas-Rio Grande Valley,3,4,Texas-Rio Grande Valley,-1
2021-03-12,@Rice,3,6,Rice,-3
2021-03-12,@Kansas State,3,4,Kansas State,-1
2021-03-13,@Rice,1,4,Rice,-3
2021-03-13,@Northern Illinois,1,3,Kansas State,-2
2021-03-19,@Kent State,6,3,Kent State,3
2021-03-20,@Kent State,2,1,Kent State,1
2021-03-20,@Kent State,3,0,Kent State,3
2021-03-21,@Kent State,4,8,Kent State,-4
2021-03-26,"@Miami, Ohio",3,4,"Miami, Ohio",-1
2021-03-27,"@Miami, Ohio",6,7,"Miami, Ohio",-1
2021-03-27,"@Miami, Ohio",1,3,"Miami, Ohio",-2
2021-03-28,"@Miami, Ohio",10,7,"Miami, Ohio",3
2021-04-02,@Northern Illinois,0,11,Central Michigan,-11
2021-04-03,@Northern Illinois,1,2,Central Michigan,-1
2021-04-03,@Northern Illinois,6,17,Central Michigan,-11
2021-04-04,@Northern Illinois,10,12,Central Michigan,-2
2021-04-09,@Bellarmine,4,7,Bellarmine,-3
2021-04-10,@Southern Illinois,12,13,Southern Illinois,-1
2021-04-11,@Southern Illinois,4,8,Southern Illinois,-4
2021-04-16,@Northern Illinois,5,19,Ohio,-14
2021-04-17,@Northern Illinois,9,1,Ohio,8
2021-04-17,@Northern Illinois,10,9,Ohio,1
2021-04-18,@Northern Illinois,6,10,Ohio,-4
2021-04-23,@Ball State,2,6,Ball State,-4
2021-04-23,@Ball State,1,3,Ball State,-2
2021-04-24,@Ball State,5,6,Ball State,-1
2021-04-25,@Ball State,1,11,Ball State,-10
2021-04-30,@Northern Illinois,7,6,Akron,1
2021-05-01,@Northern Illinois,11,2,Akron,9
2021-05-01,@Northern Illinois,3,1,Akron,2
2021-05-02,@Northern Illinois,4,7,Akron,-3
2021-05-07,@Northern Illinois,8,10,Western Michigan,-2
2021-05-08,@Northern Illinois,2,5,Western Michigan,-3
2021-05-08,@Northern Illinois,5,2,Western Michigan,3
2021-05-09,@Northern Illinois,15,5,Western Michigan,10
2021-05-14,@Eastern Michigan,4,10,Eastern Michigan,-6
2021-05-15,@Eastern Michigan,5,3,Eastern Michigan,2
2021-05-15,@Eastern Michigan,2,3,Eastern Michigan,-1
2021-05-16,@Eastern Michigan,8,5,Eastern Michigan,3
2021-05-21,@Northern Illinois,3,7,Toledo,-4
2021-05-22,@Northern Illinois,8,5,Toledo,3
2021-05-22,@Northern Illinois,1,9,Toledo,-8
2021-05-23,@Northern Illinois,1,4,Toledo,-3
2021-05-29,@Bowling Green State,0,7,Bowling Green State,-7
2021-05-29,@Bowling Green State,9,10,Bowling Green State,-1
2021-05-30,@Bowling Green State,2,1,Bowling Green State,1
2021-05-30,@Bowling Green State,4,5,Bowling Green State,-1
2021-02-20,@East Tennessee State,3,10,East Tennessee State,-7
2021-02-21,@East Tennessee State,4,3,East Tennessee State,1
2021-02-21,@East Tennessee State,2,3,East Tennessee State,-1
2021-02-26,@Belmont,11,10,Belmont,1
2021-02-26,@Belmont,4,5,Belmont,-1
2021-02-27,@Lipscomb,1,9,Lipscomb,-8
2021-02-27,@Lipscomb,8,14,Lipscomb,-6
2021-03-05,@Wright State,5,11,Wright State,-6
2021-03-06,@Wright State,1,8,Wright State,-7
2021-03-06,@Wright State,5,11,Wright State,-6
2021-03-07,@Wright State,1,13,Wright State,-12
2021-03-12,@Northern Kentucky,6,9,Oakland,-3
2021-03-13,@Northern Kentucky,2,1,Oakland,1
2021-03-13,@Northern Kentucky,15,12,Oakland,3
2021-03-14,@Northern Kentucky,18,5,Oakland,13
2021-03-19,@Northern Kentucky,5,3,Wisconsin-Milwaukee,2
2021-03-20,@Northern Kentucky,4,1,Wisconsin-Milwaukee,3
2021-03-20,@Northern Kentucky,11,1,Wisconsin-Milwaukee,10
2021-03-21,@Northern Kentucky,2,19,Wisconsin-Milwaukee,-17
2021-04-02,@IPFW,0,14,IPFW,-14
2021-04-02,@IPFW,5,4,IPFW,1
2021-04-03,@IPFW,8,9,IPFW,-1
2021-04-03,@IPFW,11,10,IPFW,1
2021-04-08,@Illinois-Chicago,11,15,Illinois-Chicago,-4
2021-04-09,@Illinois-Chicago,6,13,Illinois-Chicago,-7
2021-04-09,@Illinois-Chicago,8,5,Illinois-Chicago,3
2021-04-16,@Northern Kentucky,9,7,Youngstown State,2
2021-04-17,@Northern Kentucky,7,2,Youngstown State,5
2021-04-17,@Northern Kentucky,0,1,Youngstown State,-1
2021-04-18,@Northern Kentucky,6,18,Youngstown State,-12
2021-04-23,@Northern Kentucky,1,12,Wright State,-11
2021-04-23,@Northern Kentucky,6,8,Wright State,-2
2021-04-25,@Northern Kentucky,6,11,Wright State,-5
2021-04-25,@Northern Kentucky,2,12,Wright State,-10
2021-05-02,@Butler,6,4,Butler,2
2021-05-02,@Butler,0,3,Butler,-3
2021-05-07,@Oakland,6,9,Oakland,-3
2021-05-08,@Oakland,8,6,Oakland,2
2021-05-08,@Oakland,2,15,Oakland,-13
2021-05-09,@Oakland,3,5,Oakland,-2
2021-05-14,@Wisconsin-Milwaukee,9,4,Wisconsin-Milwaukee,5
2021-05-15,@Wisconsin-Milwaukee,5,1,Wisconsin-Milwaukee,4
2021-05-16,@Wisconsin-Milwaukee,7,12,Wisconsin-Milwaukee,-5
2021-05-16,@Wisconsin-Milwaukee,4,5,Wisconsin-Milwaukee,-1
2021-05-21,@Northern Kentucky,6,8,Illinois-Chicago,-2
2021-05-22,@Northern Kentucky,10,24,Illinois-Chicago,-14
2021-05-22,@Northern Kentucky,4,5,Illinois-Chicago,-1
2021-05-23,@Northern Kentucky,7,10,Illinois-Chicago,-3
2021-03-05,@Penn State,3,6,Penn State,-3
2021-03-06,@Penn State,2,0,Penn State,2
2021-03-06,@Penn State,5,2,Penn State,3
2021-03-07,@Penn State,10,13,Penn State,-3
2021-03-12,@Northwestern,14,2,Michigan State,12
2021-03-13,@Northwestern,3,12,Michigan State,-9
2021-03-13,@Northwestern,4,2,Michigan State,2
2021-03-14,@Northwestern,7,5,Michigan State,2
2021-03-20,@Minnesota,4,3,Minnesota,1
2021-03-21,@Minnesota,10,3,Minnesota,7
2021-03-22,@Minnesota,3,7,Minnesota,-4
2021-03-26,@Illinois,8,12,Illinois,-4
2021-03-27,@Illinois,16,14,Illinois,2
2021-03-28,@Illinois,12,5,Illinois,7
2021-04-02,@Maryland,3,4,Maryland,-1
2021-04-03,@Michigan,2,5,Michigan,-3
2021-04-03,@Maryland,4,8,Maryland,-4
2021-04-04,@Northwestern,4,1,Michigan,3
2021-04-09,@Northwestern,6,5,Rutgers,1
2021-04-10,@Northwestern,4,8,Rutgers,-4
2021-04-11,@Northwestern,5,6,Rutgers,-1
2021-04-16,@Northwestern,4,5,Indiana,-1
2021-04-17,@Northwestern,8,5,Indiana,3
2021-04-18,@Northwestern,0,4,Indiana,-4
2021-04-24,@Northwestern,1,2,Maryland,-1
2021-04-25,@Iowa,4,15,Iowa,-11
2021-04-25,@Maryland,7,9,Maryland,-2
2021-04-26,@Iowa,9,12,Iowa,-3
2021-05-14,@Nebraska,2,12,Nebraska,-10
2021-05-15,@Nebraska,5,11,Nebraska,-6
2021-05-21,@Northwestern,1,6,Iowa,-5
2021-05-22,@Northwestern,5,4,Iowa,1
2021-05-23,@Northwestern,8,6,Iowa,2
2021-05-28,@Ohio State,10,13,Ohio State,-3
2021-05-29,@Ohio State,1,4,Ohio State,-3
2021-05-30,@Ohio State,8,2,Ohio State,6
2021-02-21,@Southern Mississippi,7,1,Southern Mississippi,6
2021-02-21,@Southern Mississippi,1,5,Southern Mississippi,-4
2021-02-22,@Southern Mississippi,0,10,Southern Mississippi,-10
2021-02-24,@Louisiana-Monroe,2,5,Louisiana-Monroe,-3
2021-02-26,@Northwestern State,0,3,Tarleton State,-3
2021-02-27,@Northwestern State,5,3,Tarleton State,2
2021-02-27,@Northwestern State,2,1,Tarleton State,1
2021-03-05,@Northwestern State,10,8,Austin Peay State,2
2021-03-06,@Northwestern State,4,0,Austin Peay State,4
2021-03-07,@Northwestern State,2,3,Austin Peay State,-1
2021-03-12,@Northwestern State,5,4,Incarnate Word,1
2021-03-13,@Northwestern State,1,2,Incarnate Word,-1
2021-03-13,@Northwestern State,2,3,Incarnate Word,-1
2021-03-14,@Northwestern State,6,5,Incarnate Word,1
2021-03-19,@Sam Houston State,2,3,Sam Houston State,-1
2021-03-20,@Sam Houston State,3,2,Sam Houston State,1
2021-03-20,@Sam Houston State,3,1,Sam Houston State,2
2021-03-21,@Sam Houston State,3,6,Sam Houston State,-3
2021-03-26,@Northwestern State,6,8,South Alabama,-2
2021-03-27,@Northwestern State,5,6,South Alabama,-1
2021-03-28,@Northwestern State,1,12,South Alabama,-11
2021-03-30,@Northwestern State,7,3,LSU-Alexandria,4
2021-04-01,@Abilene Christian,8,2,Abilene Christian,6
2021-04-02,@Abilene Christian,0,11,Abilene Christian,-11
2021-04-02,@Abilene Christian,5,3,Abilene Christian,2
2021-04-03,@Abilene Christian,6,5,Abilene Christian,1
2021-04-10,@Northwestern State,4,16,Lamar,-12
2021-04-10,@Northwestern State,11,7,Lamar,4
2021-04-11,@Northwestern State,8,1,Lamar,7
2021-04-11,@Northwestern State,2,3,Lamar,-1
2021-04-16,@Houston Baptist,6,7,Houston Baptist,-1
2021-04-17,@Houston Baptist,2,6,Houston Baptist,-4
2021-04-17,@Houston Baptist,3,2,Houston Baptist,1
2021-04-18,@Houston Baptist,6,5,Houston Baptist,1
2021-04-24,@Northwestern State,7,3,Nicholls State,4
2021-04-24,@Northwestern State,13,6,Nicholls State,7
2021-04-25,@Northwestern State,3,2,Nicholls State,1
2021-04-25,@Northwestern State,2,1,Nicholls State,1
2021-04-30,@Central Arkansas,1,3,Central Arkansas,-2
2021-04-30,@Central Arkansas,8,4,Central Arkansas,4
2021-05-01,@Central Arkansas,8,13,Central Arkansas,-5
2021-05-01,@Central Arkansas,2,9,Central Arkansas,-7
2021-05-07,@Northwestern State,1,7,McNeese State,-6
2021-05-07,@Northwestern State,4,3,McNeese State,1
2021-05-08,@Northwestern State,6,5,McNeese State,1
2021-05-08,@Northwestern State,4,3,McNeese State,1
2021-05-14,@Stephen F. Austin State,3,8,Stephen F. Austin State,-5
2021-05-15,@Stephen F. Austin State,5,4,Stephen F. Austin State,1
2021-05-15,@Stephen F. Austin State,4,9,Stephen F. Austin State,-5
2021-05-16,@Stephen F. Austin State,2,7,Stephen F. Austin State,-5
2021-05-18,@Louisiana State,7,3,Louisiana State,4
2021-05-26,@Southeastern Louisiana,1,2,Southeastern Louisiana,-1
2021-05-27,@Northwestern State,1,14,New Orleans,-13
2021-02-27,@Wake Forest,5,4,Wake Forest,1
2021-02-27,@Wake Forest,8,10,Wake Forest,-2
2021-02-28,@Wake Forest,10,0,Wake Forest,10
2021-03-05,@Clemson,7,13,Clemson,-6
2021-03-06,@Clemson,3,1,Clemson,2
2021-03-07,@Clemson,3,2,Clemson,1
2021-03-12,@Virginia,10,5,Virginia,5
2021-03-13,@Virginia,12,4,Virginia,8
2021-03-14,@Virginia,8,3,Virginia,5
2021-03-19,@Notre Dame,6,4,Duke,2
2021-03-20,@Notre Dame,6,2,Duke,4
2021-03-21,@Notre Dame,0,2,Duke,-2
2021-03-23,@Notre Dame,6,3,Valparaiso,3
2021-03-26,@Notre Dame,4,7,Louisville,-3
2021-03-27,@Notre Dame,5,3,Louisville,2
2021-04-03,@Pittsburgh,4,1,Pittsburgh,3
2021-04-04,@Pittsburgh,2,3,Pittsburgh,-1
2021-04-05,@Pittsburgh,11,5,Pittsburgh,6
2021-04-09,@Notre Dame,10,9,Georgia Tech,1
2021-04-10,@Notre Dame,7,0,Georgia Tech,7
2021-04-11,@Notre Dame,2,4,Georgia Tech,-2
2021-04-13,@Notre Dame,8,4,Central Michigan,4
2021-04-16,@Notre Dame,3,2,North Carolina State,1
2021-04-17,@Notre Dame,2,5,North Carolina State,-3
2021-04-18,@Notre Dame,11,2,North Carolina State,9
2021-04-23,@Boston College,0,10,Boston College,-10
2021-04-24,@Boston College,5,2,Boston College,3
2021-04-24,@Boston College,13,9,Boston College,4
2021-04-27,@Notre Dame,8,7,Valparaiso,1
2021-04-30,@Notre Dame,4,0,North Carolina,4
2021-05-01,@Notre Dame,13,12,North Carolina,1
2021-05-02,@Notre Dame,19,5,North Carolina,14
2021-05-07,@Notre Dame,2,5,Florida State,-3
2021-05-08,@Notre Dame,5,3,Florida State,2
2021-05-08,@Notre Dame,1,7,Florida State,-6
2021-05-11,@Valparaiso,7,4,Valparaiso,3
2021-05-20,@Virginia Tech,8,2,Virginia Tech,6
2021-05-21,@Virginia Tech,4,0,Virginia Tech,4
2021-05-22,@Virginia Tech,7,1,Virginia Tech,6
2021-05-26,@Virginia Tech,8,0,Virginia Tech,8
2021-05-28,@Notre Dame,1,14,Virginia,-13
2021-06-04,@Notre Dame,10,0,Central Michigan,10
2021-06-05,@Connecticut,26,3,Connecticut,23
2021-06-06,@Notre Dame,14,2,Central Michigan,12
2021-06-12,@Mississippi State,8,9,Mississippi State,-1
2021-06-13,@Notre Dame,9,1,Mississippi State,8
2021-06-14,@Mississippi State,7,11,Mississippi State,-4
2021-02-22,@Middle Tennessee State,4,7,Middle Tennessee State,-3
2021-02-23,@Middle Tennessee State,5,2,Middle Tennessee State,3
2021-02-23,@Middle Tennessee State,1,8,Middle Tennessee State,-7
2021-02-26,@Longwood,12,0,Longwood,12
2021-02-27,@Longwood,2,1,Longwood,1
2021-02-27,@Longwood,2,3,Longwood,-1
2021-02-28,@Longwood,10,5,Longwood,5
2021-03-05,@Dayton,1,10,Dayton,-9
2021-03-06,@Dayton,2,1,Dayton,1
2021-03-06,@Dayton,5,3,Dayton,2
2021-03-07,@Dayton,6,7,Dayton,-1
2021-03-12,@Northern Kentucky,9,6,Northern Kentucky,3
2021-03-13,@Northern Kentucky,1,2,Northern Kentucky,-1
2021-03-13,@Northern Kentucky,12,15,Northern Kentucky,-3
2021-03-14,@Northern Kentucky,5,18,Northern Kentucky,-13
2021-03-19,@IPFW,9,3,IPFW,6
2021-03-20,@IPFW,3,6,IPFW,-3
2021-03-20,@IPFW,4,5,IPFW,-1
2021-03-21,@IPFW,7,8,IPFW,-1
2021-03-26,@Oakland,2,8,Illinois-Chicago,-6
2021-03-27,@Oakland,6,11,Illinois-Chicago,-5
2021-03-28,@Oakland,2,5,Illinois-Chicago,-3
2021-03-28,@Oakland,2,15,Illinois-Chicago,-13
2021-04-02,@Oakland,5,8,Wisconsin-Milwaukee,-3
2021-04-02,@Oakland,2,15,Wisconsin-Milwaukee,-13
2021-04-03,@Oakland,8,5,Wisconsin-Milwaukee,3
2021-04-03,@Oakland,13,14,Wisconsin-Milwaukee,-1
2021-04-23,@Youngstown State,3,4,Youngstown State,-1
2021-04-23,@Youngstown State,6,12,Youngstown State,-6
2021-04-24,@Youngstown State,3,4,Youngstown State,-1
2021-04-25,@Youngstown State,6,18,Youngstown State,-12
2021-04-30,@Wisconsin-Milwaukee,8,2,Wisconsin-Milwaukee,6
2021-05-01,@Wisconsin-Milwaukee,5,2,Wisconsin-Milwaukee,3
2021-05-01,@Wisconsin-Milwaukee,3,21,Wisconsin-Milwaukee,-18
2021-05-02,@Wisconsin-Milwaukee,8,6,Wisconsin-Milwaukee,2
2021-05-07,@Oakland,9,6,Northern Kentucky,3
2021-05-08,@Oakland,15,2,Northern Kentucky,13
2021-05-08,@Oakland,6,8,Northern Kentucky,-2
2021-05-09,@Oakland,5,3,Northern Kentucky,2
2021-05-14,@Wright State,0,16,Wright State,-16
2021-05-14,@Wright State,4,7,Wright State,-3
2021-05-15,@Wright State,6,14,Wright State,-8
2021-05-15,@Wright State,7,8,Wright State,-1
2021-05-21,@Oakland,17,13,IPFW,4
2021-05-21,@Oakland,4,12,IPFW,-8
2021-05-22,@Oakland,6,5,IPFW,1
2021-05-22,@Oakland,17,10,IPFW,7
2021-02-19,@Radford,3,7,Radford,-4
2021-02-20,@Radford,2,4,Radford,-2
2021-02-21,@Radford,7,5,Radford,2
2021-02-26,@Ohio,6,0,Morehead State,6
2021-02-26,@Ohio,1,3,Morehead State,-2
2021-03-05,@Ohio,14,3,Wisconsin-Milwaukee,11
2021-03-06,@Ohio,3,1,Wisconsin-Milwaukee,2
2021-03-06,@Ohio,6,4,Wisconsin-Milwaukee,2
2021-03-07,@Ohio,3,2,Wisconsin-Milwaukee,1
2021-03-09,@Morehead State,9,12,Morehead State,-3
2021-03-20,@Ohio,2,1,Bowling Green State,1
2021-03-21,@Ohio,2,6,Bowling Green State,-4
2021-03-21,@Ohio,2,5,Bowling Green State,-3
2021-03-22,@Ohio,5,11,Bowling Green State,-6
2021-03-26,@Ohio,5,1,Central Michigan,4
2021-03-27,@Ohio,4,3,Central Michigan,1
2021-03-27,@Ohio,2,12,Central Michigan,-10
2021-03-28,@Ohio,3,14,Central Michigan,-11
2021-04-02,@Toledo,13,2,Toledo,11
2021-04-03,@Toledo,5,6,Toledo,-1
2021-04-03,@Toledo,11,6,Toledo,5
2021-04-04,@Toledo,6,7,Toledo,-1
2021-04-09,@Ohio,6,3,Eastern Michigan,3
2021-04-10,@Ohio,2,1,Eastern Michigan,1
2021-04-10,@Ohio,4,3,Eastern Michigan,1
2021-04-11,@Ohio,3,2,Eastern Michigan,1
2021-04-16,@Northern Illinois,19,5,Northern Illinois,14
2021-04-17,@Northern Illinois,1,9,Northern Illinois,-8
2021-04-17,@Northern Illinois,9,10,Northern Illinois,-1
2021-04-18,@Northern Illinois,10,6,Northern Illinois,4
2021-04-23,@Ohio,12,2,IPFW,10
2021-04-23,@Ohio,5,2,IPFW,3
2021-04-24,@Ohio,9,1,IPFW,8
2021-04-30,@Kent State,2,3,Kent State,-1
2021-05-01,@Kent State,4,10,Kent State,-6
2021-05-01,@Kent State,12,6,Kent State,6
2021-05-02,@Kent State,12,1,Kent State,11
2021-05-07,@Ohio,3,1,"Miami, Ohio",2
2021-05-07,@Ohio,1,0,"Miami, Ohio",1
2021-05-08,@Ohio,5,11,"Miami, Ohio",-6
2021-05-08,@Ohio,1,6,"Miami, Ohio",-5
2021-05-14,@Akron,2,4,Akron,-2
2021-05-15,@Akron,4,0,Akron,4
2021-05-15,@Akron,1,3,Akron,-2
2021-05-16,@Akron,8,9,Akron,-1
2021-05-21,@Ohio,3,4,Ball State,-1
2021-05-22,@Ohio,2,9,Ball State,-7
2021-05-22,@Ohio,5,1,Ball State,4
2021-05-23,@Ohio,9,7,Ball State,2
2021-05-28,@Western Michigan,8,5,Western Michigan,3
2021-05-29,@Western Michigan,3,4,Western Michigan,-1
2021-05-29,@Western Michigan,2,4,Western Michigan,-2
2021-05-30,@Western Michigan,3,6,Western Michigan,-3
2021-03-05,@Illinois,6,3,Illinois,3
2021-03-06,@Illinois,12,6,Illinois,6
2021-03-06,@Illinois,6,5,Illinois,1
2021-03-07,@Illinois,0,8,Illinois,-8
2021-03-12,@Nebraska,4,10,Nebraska,-6
2021-03-12,@Iowa,0,4,Iowa,-4
2021-03-13,@Ohio State,7,4,Iowa,3
2021-03-14,@Nebraska,6,4,Nebraska,2
2021-03-20,@Rutgers,5,6,Rutgers,-1
2021-03-21,@Rutgers,0,2,Rutgers,-2
2021-03-22,@Rutgers,4,1,Rutgers,3
2021-03-26,@Ohio State,8,2,Iowa,6
2021-03-27,@Ohio State,1,5,Iowa,-4
2021-03-28,@Ohio State,5,4,Maryland,1
2021-03-29,@Ohio State,3,9,Maryland,-6
2021-04-02,@Ohio State,3,2,Indiana,1
2021-04-03,@Ohio State,6,0,Indiana,6
2021-04-03,@Ohio State,5,2,Indiana,3
2021-04-04,@Ohio State,4,3,Indiana,1
2021-04-09,@Michigan,7,4,Michigan,3
2021-04-10,@Michigan,0,7,Michigan,-7
2021-04-11,@Michigan,7,16,Michigan,-9
2021-04-16,@Maryland,6,10,Maryland,-4
2021-04-17,@Maryland,4,5,Maryland,-1
2021-04-18,@Maryland,4,9,Maryland,-5
2021-04-23,@Ohio State,11,6,Penn State,5
2021-04-24,@Ohio State,7,0,Penn State,7
2021-04-25,@Ohio State,6,10,Penn State,-4
2021-04-30,@Ohio State,11,3,Purdue,8
2021-05-01,@Ohio State,12,2,Purdue,10
2021-05-02,@Ohio State,15,16,Purdue,-1
2021-05-11,@Purdue,5,1,Purdue,4
2021-05-14,@Ohio State,7,10,Michigan State,-3
2021-05-15,@Ohio State,0,2,Michigan State,-2
2021-05-16,@Ohio State,7,3,Michigan State,4
2021-05-22,@Ohio State,9,11,Nebraska,-2
2021-05-23,@Nebraska,0,9,Nebraska,-9
2021-05-23,@Indiana,3,1,Indiana,2
2021-05-24,@Indiana,0,2,Indiana,-2
2021-05-28,@Ohio State,13,10,Northwestern,3
2021-05-29,@Ohio State,4,1,Northwestern,3
2021-05-30,@Ohio State,2,8,Northwestern,-6
2021-02-21,@Oklahoma,3,6,Nebraska-Omaha,-3
2021-02-22,@Oklahoma,8,5,Nebraska-Omaha,3
2021-02-23,@Oklahoma,5,9,Stephen F. Austin State,-4
2021-02-24,@Texas-Arlington,7,1,Texas-Arlington,6
2021-02-26,@Oklahoma,4,3,Auburn,1
2021-02-27,@Texas A&M,1,8,Texas A&M,-7
2021-02-28,@Baylor,9,3,Baylor,6
2021-03-04,@Oklahoma,13,20,Arizona,-7
2021-03-05,@Arizona,1,12,Arizona,-11
2021-03-06,@Oklahoma,16,6,Missouri,10
2021-03-07,@Dallas Baptist,3,9,Dallas Baptist,-6
2021-03-09,@Oklahoma,15,5,Texas-Arlington,10
2021-03-14,@Oklahoma,14,15,Arkansas State,-1
2021-03-14,@Oklahoma,9,1,Arkansas State,8
2021-03-15,@Oklahoma,12,6,Arkansas State,6
2021-03-16,@Arkansas,8,5,Arkansas,3
2021-03-19,@Oklahoma,7,2,Houston,5
2021-03-20,@Oklahoma,19,1,Houston,18
2021-03-21,@Oklahoma,12,2,Houston,10
2021-03-24,@Texas State,2,5,Texas State,-3
2021-03-26,@Texas,3,4,Texas,-1
2021-03-27,@Texas,6,11,Texas,-5
2021-03-28,@Texas,3,2,Texas,1
2021-03-30,@Oklahoma State,4,5,Oklahoma State,-1
2021-04-02,@Oklahoma,7,11,Texas Christian,-4
2021-04-03,@Oklahoma,6,17,Texas Christian,-11
2021-04-04,@Oklahoma,3,7,Texas Christian,-4
2021-04-06,@Oklahoma,14,12,Oral Roberts,2
2021-04-09,@Oklahoma,10,4,Kansas,6
2021-04-10,@Oklahoma,7,8,Kansas,-1
2021-04-11,@Oklahoma,14,3,Kansas,11
2021-04-14,@Oklahoma,6,0,Texas Southern,6
2021-04-14,@Oklahoma,5,1,Texas Southern,4
2021-04-17,@Kansas State,2,3,Kansas State,-1
2021-04-17,@Kansas State,6,4,Kansas State,2
2021-04-18,@Kansas State,3,8,Kansas State,-5
2021-04-24,@Oklahoma,1,4,Georgia Southern,-3
2021-04-24,@Oklahoma,2,3,Georgia Southern,-1
2021-04-25,@Oklahoma,14,4,Georgia Southern,10
2021-04-30,@Oklahoma State,16,2,Oklahoma State,14
2021-05-01,@Oklahoma,5,3,Oklahoma State,2
2021-05-02,@Oklahoma,7,8,Oklahoma State,-1
2021-05-04,@Texas Tech,4,14,Texas Tech,-10
2021-05-07,@West Virginia,1,7,West Virginia,-6
2021-05-08,@West Virginia,9,1,West Virginia,8
2021-05-08,@West Virginia,8,7,West Virginia,1
2021-05-11,@Oklahoma,3,7,Oklahoma State,-4
2021-05-14,@Oklahoma,9,8,Texas Tech,1
2021-05-15,@Oklahoma,2,15,Texas Tech,-13
2021-05-16,@Oklahoma,2,13,Texas Tech,-11
2021-05-20,@Baylor,5,9,Baylor,-4
2021-05-21,@Baylor,10,6,Baylor,4
2021-05-22,@Baylor,6,5,Baylor,1
2021-05-26,@Oklahoma State,5,9,Oklahoma State,-4
2021-05-27,@Texas,1,4,Texas,-3
2021-02-21,@Wichita State,3,1,Wichita State,2
2021-02-22,@Wichita State,14,6,Wichita State,8
2021-02-24,@Oklahoma State,7,2,Arkansas-Little Rock,5
2021-02-26,@Oklahoma State,3,2,Illinois State,1
2021-02-27,@Oklahoma State,8,2,Illinois State,6
2021-02-28,@Oklahoma State,6,0,Illinois State,6
2021-03-02,@Missouri State,7,0,Missouri State,7
2021-03-05,@Oklahoma State,11,5,Grand Canyon,6
2021-03-06,@Oklahoma State,3,0,Grand Canyon,3
2021-03-09,@Oral Roberts,5,0,Oral Roberts,5
2021-03-13,@Oklahoma State,0,5,Vanderbilt,-5
2021-03-13,@Oklahoma State,4,18,Vanderbilt,-14
2021-03-14,@Oklahoma State,10,6,Vanderbilt,4
2021-03-16,@Oklahoma State,6,13,Louisiana-Monroe,-7
2021-03-19,@Texas Tech,2,0,Texas Tech,2
2021-03-20,@Texas Tech,2,4,Texas Tech,-2
2021-03-21,@Texas Tech,5,6,Texas Tech,-1
2021-03-23,@Oklahoma State,8,11,Missouri State,-3
2021-03-26,@Oklahoma State,14,5,Kansas State,9
2021-03-27,@Oklahoma State,4,2,Kansas State,2
2021-03-28,@Oklahoma State,8,2,Kansas State,6
2021-03-30,@Oklahoma State,5,4,Oklahoma,1
2021-04-01,@Oklahoma State,3,4,West Virginia,-1
2021-04-02,@Oklahoma State,7,2,West Virginia,5
2021-04-03,@Oklahoma State,21,11,West Virginia,10
2021-04-10,@Oklahoma State,10,3,North Carolina-Wilmington,7
2021-04-10,@Oklahoma State,7,6,North Carolina-Wilmington,1
2021-04-11,@Oklahoma State,10,4,North Carolina-Wilmington,6
2021-04-16,@Texas Christian,8,9,Texas Christian,-1
2021-04-17,@Texas Christian,7,8,Texas Christian,-1
2021-04-18,@Texas Christian,6,12,Texas Christian,-6
2021-04-20,@Oklahoma State,28,0,Arkansas-Pine Bluff,28
2021-04-21,@Oklahoma State,12,2,Arkansas-Pine Bluff,10
2021-04-24,@Oklahoma State,2,5,Texas,-3
2021-04-24,@Oklahoma State,3,4,Texas,-1
2021-04-25,@Oklahoma State,7,3,Texas,4
2021-04-30,@Oklahoma State,2,16,Oklahoma,-14
2021-05-01,@Oklahoma,3,5,Oklahoma,-2
2021-05-02,@Oklahoma,8,7,Oklahoma,1
2021-05-07,@Kansas,13,4,Kansas,9
2021-05-08,@Kansas,19,0,Kansas,19
2021-05-09,@Kansas,7,8,Kansas,-1
2021-05-11,@Oklahoma,7,3,Oklahoma,4
2021-05-14,@Oklahoma State,8,7,Baylor,1
2021-05-15,@Oklahoma State,3,1,Baylor,2
2021-05-16,@Oklahoma State,3,9,Baylor,-6
2021-05-20,@Oklahoma State,9,6,New Orleans,3
2021-05-21,@Oklahoma State,15,1,New Orleans,14
2021-05-26,@Oklahoma State,9,5,Oklahoma,4
2021-05-28,@Oklahoma State,12,2,West Virginia,10
2021-05-29,@Texas,5,4,Texas,1
2021-05-30,@Texas Christian,7,10,Texas Christian,-3
2021-06-04,@Oklahoma State,4,14,UC Santa Barbara,-10
2021-06-05,@Grand Canyon,5,3,Grand Canyon,2
2021-06-06,@UC Santa Barbara,3,13,UC Santa Barbara,-10
2021-02-20,@Old Dominion,7,1,Norfolk State,6
2021-02-21,@Old Dominion,12,0,Norfolk State,12
2021-02-23,@Old Dominion,12,5,Norfolk State,7
2021-02-24,@Old Dominion,19,2,Norfolk State,17
2021-02-26,@Old Dominion,4,6,Rhode Island,-2
2021-02-27,@Old Dominion,5,6,Rhode Island,-1
2021-02-28,@Old Dominion,16,3,Rhode Island,13
2021-03-03,@East Carolina,6,5,East Carolina,1
2021-03-05,@Old Dominion,10,8,Northeastern,2
2021-03-06,@Old Dominion,5,6,Northeastern,-1
2021-03-07,@Old Dominion,3,2,Northeastern,1
2021-03-10,@William and Mary,8,2,William and Mary,6
2021-03-12,@Old Dominion,6,3,Ball State,3
2021-03-13,@Old Dominion,10,5,Ball State,5
2021-03-14,@Old Dominion,2,1,Ball State,1
2021-03-17,@Old Dominion,5,12,Virginia Commonwealth,-7
2021-03-20,@Richmond,4,3,Richmond,1
2021-03-23,@Virginia Commonwealth,5,3,Virginia Commonwealth,2
2021-03-26,@Old Dominion,12,15,Florida International,-3
2021-03-27,@Old Dominion,14,0,Florida International,14
2021-03-27,@Old Dominion,3,2,Florida International,1
2021-03-28,@Old Dominion,16,9,Florida International,7
2021-04-02,@Marshall,12,1,Marshall,11
2021-04-03,@Marshall,8,7,Marshall,1
2021-04-03,@Marshall,8,0,Marshall,8
2021-04-04,@Marshall,15,7,Marshall,8
2021-04-09,@Florida Atlantic,7,2,Florida Atlantic,5
2021-04-10,@Florida Atlantic,8,2,Florida Atlantic,6
2021-04-10,@Florida Atlantic,10,3,Florida Atlantic,7
2021-04-11,@Florida Atlantic,0,4,Florida Atlantic,-4
2021-04-16,@Old Dominion,11,4,Rice,7
2021-04-17,@Old Dominion,11,2,Rice,9
2021-04-17,@Old Dominion,2,11,Rice,-9
2021-04-18,@Old Dominion,4,1,Rice,3
2021-04-23,@North Carolina-Charlotte,9,5,North Carolina-Charlotte,4
2021-04-23,@North Carolina-Charlotte,4,5,North Carolina-Charlotte,-1
2021-04-25,@North Carolina-Charlotte,3,8,North Carolina-Charlotte,-5
2021-04-25,@North Carolina-Charlotte,1,7,North Carolina-Charlotte,-6
2021-04-30,@Old Dominion,8,3,North Carolina-Charlotte,5
2021-05-01,@Old Dominion,2,6,North Carolina-Charlotte,-4
2021-05-01,@Old Dominion,14,2,North Carolina-Charlotte,12
2021-05-02,@Old Dominion,10,0,North Carolina-Charlotte,10
2021-05-07,@Texas-San Antonio,14,11,Texas-San Antonio,3
2021-05-08,@Texas-San Antonio,10,12,Texas-San Antonio,-2
2021-05-08,@Texas-San Antonio,0,11,Texas-San Antonio,-11
2021-05-09,@Texas-San Antonio,6,2,Texas-San Antonio,4
2021-05-14,@Old Dominion,14,8,Western Kentucky,6
2021-05-15,@Old Dominion,6,7,Western Kentucky,-1
2021-05-15,@Old Dominion,6,3,Western Kentucky,3
2021-05-16,@Old Dominion,13,2,Western Kentucky,11
2021-05-20,@Louisiana Tech,10,8,Louisiana Tech,2
2021-05-21,@Louisiana Tech,8,7,Louisiana Tech,1
2021-05-26,@Old Dominion,11,2,Florida Atlantic,9
2021-05-27,@Old Dominion,10,6,Middle Tennessee State,4
2021-05-29,@Old Dominion,13,5,Florida Atlantic,8
2021-05-30,@Louisiana Tech,7,5,Louisiana Tech,2
2021-06-04,@Old Dominion,4,3,Jacksonville,1
2021-06-05,@South Carolina,2,1,South Carolina,1
2021-06-06,@Old Dominion,3,8,Virginia,-5
2021-06-08,@Virginia,3,4,Virginia,-1
2021-02-21,@Oral Roberts,3,4,Arkansas-Little Rock,-1
2021-02-22,@Oral Roberts,7,3,Arkansas-Little Rock,4
2021-02-23,@Oral Roberts,2,8,Missouri State,-6
2021-02-24,@Oral Roberts,11,14,Missouri State,-3
2021-02-26,@Oral Roberts,1,7,South Alabama,-6
2021-02-27,@Oral Roberts,9,2,South Alabama,7
2021-02-27,@Oral Roberts,3,4,South Alabama,-1
2021-03-02,@Oral Roberts,0,3,Wichita State,-3
2021-03-05,@Louisiana State,22,7,Louisiana State,15
2021-03-06,@Louisiana State,0,12,Louisiana State,-12
2021-03-07,@Louisiana State,3,1,Louisiana State,2
2021-03-09,@Oral Roberts,0,5,Oklahoma State,-5
2021-03-12,@Dallas Baptist,10,7,Dallas Baptist,3
2021-03-13,@Dallas Baptist,7,6,Dallas Baptist,1
2021-03-14,@Dallas Baptist,6,17,Dallas Baptist,-11
2021-03-16,@Missouri State,1,5,Missouri State,-4
2021-03-19,@St. Louis,14,7,St. Louis,7
2021-03-20,@St. Louis,2,6,St. Louis,-4
2021-03-21,@St. Louis,1,4,St. Louis,-3
2021-03-26,@Oral Roberts,5,4,North Dakota State,1
2021-03-26,@Oral Roberts,3,6,North Dakota State,-3
2021-03-27,@Oral Roberts,5,3,North Dakota State,2
2021-03-28,@Oral Roberts,7,9,North Dakota State,-2
2021-04-01,@Western Illinois,6,4,Western Illinois,2
2021-04-02,@Western Illinois,10,0,Western Illinois,10
2021-04-02,@Western Illinois,8,9,Western Illinois,-1
2021-04-03,@Western Illinois,18,5,Western Illinois,13
2021-04-06,@Oklahoma,12,14,Oklahoma,-2
2021-04-09,@Oral Roberts,6,1,Houston Baptist,5
2021-04-10,@Oral Roberts,3,1,Houston Baptist,2
2021-04-11,@Oral Roberts,0,2,Houston Baptist,-2
2021-04-16,@North Dakota State,8,6,North Dakota State,2
2021-04-17,@North Dakota State,11,14,North Dakota State,-3
2021-04-17,@North Dakota State,18,2,North Dakota State,16
2021-04-30,@Oral Roberts,14,4,South Dakota State,10
2021-05-01,@Oral Roberts,6,2,South Dakota State,4
2021-05-01,@Oral Roberts,1,0,South Dakota State,1
2021-05-02,@Oral Roberts,9,0,South Dakota State,9
2021-05-07,@Oral Roberts,4,5,Western Illinois,-1
2021-05-07,@Oral Roberts,3,2,Western Illinois,1
2021-05-08,@Oral Roberts,9,1,Western Illinois,8
2021-05-09,@Oral Roberts,10,0,Western Illinois,10
2021-05-14,@Nebraska-Omaha,2,1,Nebraska-Omaha,1
2021-05-14,@Nebraska-Omaha,12,3,Nebraska-Omaha,9
2021-05-15,@Nebraska-Omaha,17,12,Nebraska-Omaha,5
2021-05-20,@South Dakota State,11,8,South Dakota State,3
2021-05-20,@South Dakota State,4,3,South Dakota State,1
2021-05-21,@South Dakota State,3,4,South Dakota State,-1
2021-05-22,@South Dakota State,4,7,South Dakota State,-3
2021-05-27,@Oral Roberts,7,1,South Dakota State,6
2021-05-28,@South Dakota State,5,3,South Dakota State,2
2021-05-28,@Oral Roberts,0,5,North Dakota State,-5
2021-05-29,@North Dakota State,15,5,North Dakota State,10
2021-05-29,@Oral Roberts,6,11,North Dakota State,-5
2021-02-25,@Oregon,4,3,Seattle,1
2021-02-26,@Oregon,6,0,Seattle,6
2021-02-27,@Oregon,2,4,Seattle,-2
2021-02-28,@Oregon,4,8,Seattle,-4
2021-03-05,@UC Santa Barbara,7,6,UC Santa Barbara,1
2021-03-06,@UC Santa Barbara,17,2,UC Santa Barbara,15
2021-03-06,@UC Santa Barbara,5,4,UC Santa Barbara,1
2021-03-07,@UC Santa Barbara,9,4,UC Santa Barbara,5
2021-03-12,@Oregon State,7,0,Oregon State,7
2021-03-13,@Oregon State,3,0,Oregon State,3
2021-03-14,@Oregon State,1,3,Oregon State,-2
2021-03-19,@Oregon,3,6,Arizona State,-3
2021-03-20,@Oregon,7,1,Arizona State,6
2021-03-21,@Oregon,5,3,Arizona State,2
2021-03-23,@Oregon,10,1,Portland,9
2021-03-26,@Arizona,4,5,Arizona,-1
2021-03-27,@Arizona,2,15,Arizona,-13
2021-03-28,@Arizona,18,13,Arizona,5
2021-04-01,@Oregon,5,0,New Mexico State,5
2021-04-02,@Oregon,8,2,New Mexico State,6
2021-04-03,@Oregon,6,1,New Mexico State,5
2021-04-03,@Oregon,2,1,New Mexico State,1
2021-04-06,@Oregon,4,6,Portland,-2
2021-04-09,@Oregon,4,1,Oregon State,3
2021-04-10,@Oregon,5,1,Oregon State,4
2021-04-11,@Oregon,5,4,Oregon State,1
2021-04-14,@Portland,18,1,Portland,17
2021-04-16,@Southern California,5,9,Southern California,-4
2021-04-17,@Southern California,13,4,Southern California,9
2021-04-18,@Southern California,7,5,Southern California,2
2021-04-23,@Oregon,5,3,UCLA,2
2021-04-24,@Oregon,3,2,UCLA,1
2021-04-25,@Oregon,6,7,UCLA,-1
2021-04-27,@Oregon,11,7,San Jose State,4
2021-04-28,@Oregon,13,1,San Jose State,12
2021-04-30,@Washington State,13,0,Washington State,13
2021-05-01,@Washington State,1,11,Washington State,-10
2021-05-02,@Washington State,6,11,Washington State,-5
2021-05-07,@Oregon,8,0,Washington,8
2021-05-08,@Oregon,5,1,Washington,4
2021-05-09,@Oregon,9,3,Washington,6
2021-05-14,@Utah,7,3,Utah,4
2021-05-15,@Utah,16,3,Utah,13
2021-05-16,@Utah,9,2,Utah,7
2021-05-18,@Oregon,10,3,Gonzaga,7
2021-05-21,@Oregon,2,1,Stanford,1
2021-05-22,@Oregon,5,6,Stanford,-1
2021-05-23,@Oregon,5,8,Stanford,-3
2021-05-27,@California,11,5,California,6
2021-05-28,@California,3,10,California,-7
2021-05-29,@California,6,5,California,1
2021-06-04,@Oregon,13,10,Central Connecticut State,3
2021-06-05,@Gonzaga,7,3,Gonzaga,4
2021-06-06,@Oregon,1,4,Louisiana State,-3
2021-06-07,@Louisiana State,8,9,Louisiana State,-1
2021-02-19,@Oregon State,2,3,Kansas State,-1
2021-02-20,@Oregon State,14,1,New Mexico,13
2021-02-21,@Oregon State,20,4,Gonzaga,16
2021-02-22,@Oregon State,5,2,New Mexico,3
2021-02-25,@Grand Canyon,4,0,Grand Canyon,4
2021-02-26,@Grand Canyon,3,1,Grand Canyon,2
2021-02-27,@Grand Canyon,9,2,Grand Canyon,7
2021-02-28,@Grand Canyon,4,2,Grand Canyon,2
2021-03-04,@Oregon State,1,0,Brigham Young,1
2021-03-05,@Oregon State,5,3,Brigham Young,2
2021-03-06,@Oregon State,4,3,Brigham Young,1
2021-03-12,@Oregon State,0,7,Oregon,-7
2021-03-13,@Oregon State,0,3,Oregon,-3
2021-03-14,@Oregon State,3,1,Oregon,2
2021-03-19,@Oregon State,2,5,Washington State,-3
2021-03-20,@Oregon State,10,3,Washington State,7
2021-03-21,@Oregon State,9,8,Washington State,1
2021-03-23,@Oregon State,9,10,Santa Clara,-1
2021-03-24,@Oregon State,9,0,Santa Clara,9
2021-03-26,@Washington,3,0,Washington,3
2021-03-27,@Washington,8,1,Washington,7
2021-03-29,@Washington,13,3,Washington,10
2021-03-30,@Portland,7,1,Portland,6
2021-04-01,@Oregon State,4,3,Utah,1
2021-04-02,@Oregon State,17,3,Utah,14
2021-04-03,@Oregon State,3,5,Utah,-2
2021-04-05,@Oregon State,11,3,Gonzaga,8
2021-04-06,@Oregon State,2,5,Gonzaga,-3
2021-04-09,@Oregon,1,4,Oregon,-3
2021-04-10,@Oregon,1,5,Oregon,-4
2021-04-11,@Oregon,4,5,Oregon,-1
2021-04-16,@Oregon State,15,8,California,7
2021-04-17,@Oregon State,2,1,California,1
2021-04-18,@Oregon State,5,3,California,2
2021-04-20,@Oregon State,11,3,Portland,8
2021-04-23,@UC Irvine,7,5,UC Irvine,2
2021-04-24,@UC Irvine,9,11,UC Irvine,-2
2021-04-25,@UC Irvine,6,7,UC Irvine,-1
2021-04-27,@Loyola Marymount,8,2,Loyola Marymount,6
2021-04-28,@Loyola Marymount,8,5,Loyola Marymount,3
2021-04-30,@UCLA,5,6,UCLA,-1
2021-05-01,@UCLA,0,2,UCLA,-2
2021-05-02,@UCLA,5,3,UCLA,2
2021-05-07,@Oregon State,5,4,Southern California,1
2021-05-08,@Oregon State,9,7,Southern California,2
2021-05-09,@Oregon State,3,5,Southern California,-2
2021-05-14,@Arizona State,6,9,Arizona State,-3
2021-05-15,@Arizona State,5,11,Arizona State,-6
2021-05-16,@Arizona State,11,4,Arizona State,7
2021-05-18,@Portland,2,7,Portland,-5
2021-05-21,@Oregon State,4,12,Arizona,-8
2021-05-22,@Oregon State,3,1,Arizona,2
2021-05-23,@Oregon State,5,6,Arizona,-1
2021-05-27,@Stanford,0,1,Stanford,-1
2021-05-28,@Stanford,0,5,Stanford,-5
2021-05-29,@Stanford,9,1,Stanford,8
2021-06-04,@Oregon State,5,6,Dallas Baptist,-1
2021-06-05,@McNeese State,10,5,McNeese State,5
2021-06-06,@Texas Christian,3,2,Texas Christian,1
2021-06-06,@Oregon State,5,4,Dallas Baptist,1
2021-06-07,@Dallas Baptist,5,8,Dallas Baptist,-3
2021-02-19,@California,3,4,California,-1
2021-02-20,@California,6,3,California,3
2021-02-21,@Pacific,5,2,California,3
2021-02-22,@Pacific,7,6,California,1
2021-03-01,@Sacramento State,5,8,Sacramento State,-3
2021-03-05,@CSU Bakersfield,12,4,CSU Bakersfield,8
2021-03-06,@CSU Bakersfield,8,5,CSU Bakersfield,3
2021-03-06,@CSU Bakersfield,9,10,CSU Bakersfield,-1
2021-03-07,@CSU Bakersfield,1,2,CSU Bakersfield,-1
2021-03-12,@Pacific,1,3,St. Mary's,-2
2021-03-13,@Pacific,4,5,St. Mary's,-1
2021-03-13,@Pacific,3,4,St. Mary's,-1
2021-03-14,@St. Mary's,7,5,St. Mary's,2
2021-03-17,@Pacific,3,2,Fresno State,1
2021-03-19,@Pacific,2,12,Portland,-10
2021-03-20,@Pacific,3,9,Portland,-6
2021-03-21,@Pacific,5,18,Portland,-13
2021-03-24,@Fresno State,4,5,Fresno State,-1
2021-03-26,@San Diego,1,3,San Diego,-2
2021-03-27,@San Diego,3,15,San Diego,-12
2021-03-28,@San Diego,1,5,San Diego,-4
2021-04-01,@Gonzaga,0,9,Gonzaga,-9
2021-04-02,@Gonzaga,0,6,Gonzaga,-6
2021-04-03,@Gonzaga,1,2,Gonzaga,-1
2021-04-07,@Fresno State,14,10,Fresno State,4
2021-04-08,@Nevada-Las Vegas,4,8,Nevada-Las Vegas,-4
2021-04-09,@Nevada-Las Vegas,2,3,Nevada-Las Vegas,-1
2021-04-10,@Nevada-Las Vegas,0,10,Nevada-Las Vegas,-10
2021-04-14,@Stanford,0,2,Stanford,-2
2021-04-16,@Pacific,2,3,Long Beach State,-1
2021-04-17,@Pacific,17,12,Long Beach State,5
2021-04-18,@Pacific,10,28,Long Beach State,-18
2021-04-23,@St. Mary's,9,4,St. Mary's,5
2021-04-24,@St. Mary's,2,3,St. Mary's,-1
2021-04-24,@St. Mary's,2,3,St. Mary's,-1
2021-04-28,@Pacific,15,12,Stanford,3
2021-04-30,@Pacific,8,7,San Francisco,1
2021-05-01,@Pacific,4,6,San Francisco,-2
2021-05-02,@Pacific,4,17,San Francisco,-13
2021-05-07,@Santa Clara,11,7,Santa Clara,4
2021-05-08,@Santa Clara,6,7,Santa Clara,-1
2021-05-09,@Santa Clara,11,3,Santa Clara,8
2021-05-13,@Pacific,6,3,Brigham Young,3
2021-05-14,@Pacific,0,5,Brigham Young,-5
2021-05-15,@Pacific,0,6,Brigham Young,-6
2021-05-21,@Loyola Marymount,2,7,Loyola Marymount,-5
2021-05-22,@Loyola Marymount,3,2,Loyola Marymount,1
2021-05-23,@Loyola Marymount,3,10,Loyola Marymount,-7
2021-05-27,@Pacific,6,13,Pepperdine,-7
2021-05-28,@Pacific,11,7,Pepperdine,4
2021-05-29,@Pacific,2,16,Pepperdine,-14
2021-03-05,@Penn State,6,3,Northwestern,3
2021-03-06,@Penn State,2,5,Northwestern,-3
2021-03-06,@Penn State,0,2,Northwestern,-2
2021-03-07,@Penn State,13,10,Northwestern,3
2021-03-13,@Indiana,0,8,Indiana,-8
2021-03-13,@Indiana,2,7,Indiana,-5
2021-03-14,@Indiana,5,6,Indiana,-1
2021-03-14,@Indiana,1,2,Indiana,-1
2021-03-20,@Penn State,10,19,Maryland,-9
2021-03-21,@Penn State,6,5,Maryland,1
2021-03-22,@Penn State,1,7,Maryland,-6
2021-03-26,@Penn State,3,2,Michigan,1
2021-03-27,@Penn State,6,8,Michigan,-2
2021-03-27,@Penn State,4,17,Michigan,-13
2021-04-02,@Rutgers,1,0,Rutgers,1
2021-04-03,@Rutgers,5,1,Rutgers,4
2021-04-04,@Rutgers,4,6,Rutgers,-2
2021-04-09,@Michigan State,4,7,Michigan State,-3
2021-04-09,@Michigan State,7,3,Michigan State,4
2021-04-10,@Purdue,11,0,Purdue,11
2021-04-11,@Penn State,5,8,Purdue,-3
2021-04-16,@Penn State,2,8,Nebraska,-6
2021-04-17,@Penn State,2,11,Nebraska,-9
2021-04-18,@Penn State,3,5,Nebraska,-2
2021-04-23,@Ohio State,6,11,Ohio State,-5
2021-04-24,@Ohio State,0,7,Ohio State,-7
2021-04-25,@Ohio State,10,6,Ohio State,4
2021-04-30,@Penn State,7,6,Michigan State,1
2021-05-01,@Penn State,27,4,Michigan State,23
2021-05-02,@Penn State,5,3,Michigan State,2
2021-05-07,@Iowa,2,4,Iowa,-2
2021-05-08,@Iowa,3,5,Iowa,-2
2021-05-08,@Iowa,5,4,Iowa,1
2021-05-14,@Penn State,7,3,Rutgers,4
2021-05-15,@Penn State,4,3,Rutgers,1
2021-05-16,@Penn State,0,5,Rutgers,-5
2021-05-17,@Penn State,8,6,Rutgers,2
2021-05-21,@Illinois,0,9,Illinois,-9
2021-05-22,@Illinois,8,14,Illinois,-6
2021-05-23,@Illinois,13,4,Illinois,9
2021-05-29,@Minnesota,7,3,Minnesota,4
2021-05-29,@Purdue,4,7,Purdue,-3
2021-02-19,@California Baptist,1,9,California Baptist,-8
2021-02-20,@Pepperdine,10,6,California Baptist,4
2021-02-21,@California Baptist,2,6,California Baptist,-4
2021-02-26,@Pepperdine,6,7,UC Santa Barbara,-1
2021-02-27,@UC Santa Barbara,7,9,UC Santa Barbara,-2
2021-02-27,@UC Santa Barbara,0,5,UC Santa Barbara,-5
2021-02-28,@Pepperdine,2,12,UC Santa Barbara,-10
2021-03-05,@UCLA,8,16,UCLA,-8
2021-03-06,@Southern California,11,5,Southern California,6
2021-03-07,@Cal State Fullerton,10,4,Cal State Fullerton,6
2021-03-12,@UC Davis,5,10,UC Davis,-5
2021-03-13,@UC Davis,3,5,UC Davis,-2
2021-03-13,@UC Davis,15,0,UC Davis,15
2021-03-14,@UC Davis,5,2,UC Davis,3
2021-03-19,@San Francisco,16,2,San Francisco,14
2021-03-20,@San Francisco,6,7,San Francisco,-1
2021-03-21,@San Francisco,10,8,San Francisco,2
2021-03-23,@Grand Canyon,14,5,Grand Canyon,9
2021-03-24,@Grand Canyon,4,3,Grand Canyon,1
2021-03-26,@Pepperdine,4,0,St. Mary's,4
2021-03-27,@Pepperdine,7,2,St. Mary's,5
2021-03-28,@Pepperdine,2,3,St. Mary's,-1
2021-04-16,@Pepperdine,0,10,Gonzaga,-10
2021-04-17,@Pepperdine,4,3,Gonzaga,1
2021-04-18,@Pepperdine,6,11,Gonzaga,-5
2021-04-20,@Pepperdine,4,5,UCLA,-1
2021-04-23,@Pepperdine,1,4,Loyola Marymount,-3
2021-04-24,@Pepperdine,4,5,Loyola Marymount,-1
2021-04-25,@Pepperdine,18,4,Loyola Marymount,14
2021-04-27,@Southern California,5,2,Southern California,3
2021-04-30,@San Diego,3,8,San Diego,-5
2021-05-01,@San Diego,6,7,San Diego,-1
2021-05-02,@San Diego,9,10,San Diego,-1
2021-05-07,@Portland,6,9,Portland,-3
2021-05-08,@Portland,7,5,Portland,2
2021-05-09,@Portland,2,6,Portland,-4
2021-05-14,@Pepperdine,0,11,Santa Clara,-11
2021-05-15,@Pepperdine,8,4,Santa Clara,4
2021-05-16,@Pepperdine,3,2,Santa Clara,1
2021-05-20,@Brigham Young,6,3,Brigham Young,3
2021-05-21,@Brigham Young,5,14,Brigham Young,-9
2021-05-22,@Brigham Young,7,14,Brigham Young,-7
2021-05-27,@Pacific,13,6,Pacific,7
2021-05-28,@Pacific,7,11,Pacific,-4
2021-05-29,@Pacific,16,2,Pacific,14
2021-02-19,@Pittsburgh,0,4,Indiana State,-4
2021-02-20,@Indiana State,8,2,Indiana State,6
2021-02-21,@Pittsburgh,10,1,Indiana State,9
2021-02-23,@Jacksonville,7,2,Jacksonville,5
2021-02-26,@Florida State,1,0,Florida State,1
2021-02-27,@Florida State,7,2,Florida State,5
2021-02-28,@Florida State,9,7,Florida State,2
2021-03-05,@Duke,1,3,Duke,-2
2021-03-06,@Duke,1,8,Duke,-7
2021-03-07,@Duke,5,4,Duke,1
2021-03-12,@Georgia Tech,11,9,Georgia Tech,2
2021-03-13,@Georgia Tech,3,5,Georgia Tech,-2
2021-03-14,@Georgia Tech,18,12,Georgia Tech,6
2021-03-20,@Virginia,2,1,Virginia,1
2021-03-21,@Virginia,6,2,Virginia,4
2021-03-22,@Virginia,4,10,Virginia,-6
2021-03-24,@Pittsburgh,17,9,Bucknell,8
2021-03-26,@Pittsburgh,1,5,Virginia Tech,-4
2021-03-27,@Pittsburgh,4,8,Virginia Tech,-4
2021-03-28,@Pittsburgh,4,8,Virginia Tech,-4
2021-04-03,@Pittsburgh,1,4,Notre Dame,-3
2021-04-04,@Pittsburgh,3,2,Notre Dame,1
2021-04-05,@Pittsburgh,5,11,Notre Dame,-6
2021-04-06,@Pittsburgh,5,1,West Virginia,4
2021-04-09,@Pittsburgh,12,6,"Miami, Florida",6
2021-04-10,@Pittsburgh,6,4,"Miami, Florida",2
2021-04-11,@Pittsburgh,12,5,"Miami, Florida",7
2021-04-13,@Pittsburgh,9,6,Lipscomb,3
2021-04-17,@Pittsburgh,6,2,North Carolina,4
2021-04-17,@Pittsburgh,3,2,North Carolina,1
2021-04-18,@Pittsburgh,9,10,North Carolina,-1
2021-05-05,@West Virginia,2,8,West Virginia,-6
2021-05-07,@Pittsburgh,4,1,Boston College,3
2021-05-08,@Pittsburgh,2,6,Boston College,-4
2021-05-08,@Pittsburgh,4,3,Boston College,1
2021-05-14,@Pittsburgh,2,3,North Carolina State,-1
2021-05-15,@Pittsburgh,7,9,North Carolina State,-2
2021-05-16,@Pittsburgh,3,10,North Carolina State,-7
2021-05-20,@Wake Forest,1,6,Wake Forest,-5
2021-05-21,@Wake Forest,5,12,Wake Forest,-7
2021-05-22,@Wake Forest,2,10,Wake Forest,-8
2021-05-25,@North Carolina,5,3,North Carolina,2
2021-05-27,@Pittsburgh,2,3,North Carolina State,-1
2021-02-21,@Portland,7,0,Seattle,7
2021-02-21,@Portland,4,5,Seattle,-1
2021-02-22,@Portland,3,5,Seattle,-2
2021-02-28,@UC Davis,0,1,UC Davis,-1
2021-02-28,@UC Davis,7,4,UC Davis,3
2021-03-01,@UC Davis,1,8,UC Davis,-7
2021-03-05,@Gonzaga,2,0,Gonzaga,2
2021-03-06,@Gonzaga,0,7,Gonzaga,-7
2021-03-07,@Gonzaga,1,8,Gonzaga,-7
2021-03-09,@Washington,1,2,Washington,-1
2021-03-12,@Portland,10,6,Utah Valley,4
2021-03-13,@Portland,3,0,Utah Valley,3
2021-03-13,@Portland,6,5,Utah Valley,1
2021-03-14,@Portland,5,1,Utah Valley,4
2021-03-17,@Portland,4,6,Washington State,-2
2021-03-19,@Pacific,12,2,Pacific,10
2021-03-20,@Pacific,9,3,Pacific,6
2021-03-21,@Pacific,18,5,Pacific,13
2021-03-23,@Oregon,1,10,Oregon,-9
2021-03-26,@Portland,3,2,Santa Clara,1
2021-03-27,@Portland,2,8,Santa Clara,-6
2021-03-28,@Portland,2,4,Santa Clara,-2
2021-03-30,@Portland,1,7,Oregon State,-6
2021-04-01,@St. Mary's,4,3,St. Mary's,1
2021-04-02,@St. Mary's,2,14,St. Mary's,-12
2021-04-03,@St. Mary's,3,0,St. Mary's,3
2021-04-06,@Oregon,6,4,Oregon,2
2021-04-08,@Brigham Young,5,3,Brigham Young,2
2021-04-09,@Brigham Young,0,1,Brigham Young,-1
2021-04-10,@Brigham Young,7,6,Brigham Young,1
2021-04-13,@Portland,4,6,Washington,-2
2021-04-14,@Portland,1,18,Oregon,-17
2021-04-16,@Portland,5,8,Loyola Marymount,-3
2021-04-17,@Portland,9,1,Loyola Marymount,8
2021-04-18,@Portland,8,2,Loyola Marymount,6
2021-04-20,@Oregon State,3,11,Oregon State,-8
2021-04-23,@San Francisco,0,5,San Francisco,-5
2021-04-24,@San Francisco,5,4,San Francisco,1
2021-04-24,@San Francisco,4,6,San Francisco,-2
2021-05-07,@Portland,9,6,Pepperdine,3
2021-05-08,@Portland,5,7,Pepperdine,-2
2021-05-09,@Portland,6,2,Pepperdine,4
2021-05-11,@Washington State,10,6,Washington State,4
2021-05-14,@Portland,4,12,Gonzaga,-8
2021-05-15,@Portland,3,6,Gonzaga,-3
2021-05-16,@Portland,3,5,Gonzaga,-2
2021-05-18,@Portland,7,2,Oregon State,5
2021-05-20,@San Diego,1,7,San Diego,-6
2021-05-21,@San Diego,3,4,San Diego,-1
2021-05-22,@San Diego,6,2,San Diego,4
2021-02-26,@McNeese State,0,5,McNeese State,-5
2021-02-27,@McNeese State,1,3,McNeese State,-2
2021-02-27,@McNeese State,5,6,McNeese State,-1
2021-02-28,@McNeese State,5,11,McNeese State,-6
2021-03-03,@Rice,0,10,Rice,-10
2021-03-05,@Texas Southern,2,3,Texas Southern,-1
2021-03-06,@Texas Southern,3,9,Texas Southern,-6
2021-03-07,@Texas Southern,2,7,Texas Southern,-5
2021-03-10,@Texas A&M,2,22,Texas A&M,-20
2021-03-12,@Prairie View A&M,5,7,Southern,-2
2021-03-13,@Prairie View A&M,12,10,Southern,2
2021-03-13,@Prairie View A&M,12,4,Southern,8
2021-03-17,@Baylor,2,12,Baylor,-10
2021-03-19,@Arkansas-Pine Bluff,5,2,Arkansas-Pine Bluff,3
2021-04-06,@Incarnate Word,1,12,Incarnate Word,-11
2021-04-09,@Prairie View A&M,4,6,Texas Southern,-2
2021-04-10,@Prairie View A&M,4,2,Texas Southern,2
2021-04-11,@Prairie View A&M,4,14,Texas Southern,-10
2021-04-18,@Southern,5,1,Southern,4
2021-04-19,@Southern,6,4,Southern,2
2021-04-19,@Southern,4,0,Southern,4
2021-04-24,@Prairie View A&M,8,1,Arkansas-Pine Bluff,7
2021-04-24,@Prairie View A&M,11,8,Arkansas-Pine Bluff,3
2021-04-25,@Prairie View A&M,15,7,Arkansas-Pine Bluff,8
2021-04-27,@Baylor,0,14,Baylor,-14
2021-04-30,@Grambling State,2,5,Grambling State,-3
2021-05-01,@Grambling State,15,4,Grambling State,11
2021-05-01,@Grambling State,12,1,Grambling State,11
2021-05-19,@Prairie View A&M,2,0,Alcorn State,2
2021-05-20,@Prairie View A&M,2,1,Southern,1
2021-05-21,@Prairie View A&M,3,24,Southern,-21
2021-05-22,@Prairie View A&M,4,8,Southern,-4
2021-02-19,@Auburn,3,14,Auburn,-11
2021-02-20,@Auburn,1,6,Auburn,-5
2021-02-21,@Auburn,1,2,Auburn,-1
2021-02-24,@Presbyterian,4,11,Wofford,-7
2021-02-27,@Eastern Kentucky,3,5,Eastern Kentucky,-2
2021-02-27,@Eastern Kentucky,12,9,Eastern Kentucky,3
2021-03-16,@Presbyterian,2,8,Charleston Southern,-6
2021-03-19,@Radford,7,6,Radford,1
2021-03-20,@Radford,5,12,Radford,-7
2021-03-23,@South Carolina-Upstate,0,13,South Carolina-Upstate,-13
2021-03-26,@Presbyterian,2,1,Charleston Southern,1
2021-03-27,@Presbyterian,3,0,Charleston Southern,3
2021-03-27,@Presbyterian,3,1,Charleston Southern,2
2021-04-02,@North Carolina-Asheville,6,1,North Carolina-Asheville,5
2021-04-03,@North Carolina-Asheville,5,8,North Carolina-Asheville,-3
2021-04-03,@North Carolina-Asheville,6,7,North Carolina-Asheville,-1
2021-04-06,@Presbyterian,5,4,North Carolina-Asheville,1
2021-04-16,@Longwood,5,8,Longwood,-3
2021-04-16,@Longwood,7,6,Longwood,1
2021-04-17,@Longwood,10,9,Longwood,1
2021-04-17,@Longwood,6,5,Longwood,1
2021-04-20,@Presbyterian,8,11,South Carolina-Upstate,-3
2021-04-23,@Presbyterian,7,6,Campbell,1
2021-04-25,@Presbyterian,5,21,Campbell,-16
2021-04-25,@Presbyterian,12,6,Campbell,6
2021-04-27,@North Carolina-Asheville,2,6,North Carolina-Asheville,-4
2021-04-30,@South Carolina-Upstate,1,8,South Carolina-Upstate,-7
2021-05-01,@South Carolina-Upstate,11,12,South Carolina-Upstate,-1
2021-05-01,@South Carolina-Upstate,4,8,South Carolina-Upstate,-4
2021-05-05,@Presbyterian,4,2,North Carolina-Asheville,2
2021-05-07,@Presbyterian,2,10,Gardner-Webb,-8
2021-05-08,@Presbyterian,6,10,Gardner-Webb,-4
2021-05-08,@Presbyterian,9,3,Gardner-Webb,6
2021-05-11,@Charleston Southern,8,9,Charleston Southern,-1
2021-05-14,@High Point,11,4,High Point,7
2021-05-15,@High Point,10,6,High Point,4
2021-05-15,@High Point,13,11,High Point,2
2021-05-20,@Winthrop,5,2,Winthrop,3
2021-05-21,@Winthrop,7,6,Winthrop,1
2021-05-21,@Winthrop,12,13,Winthrop,-1
2021-05-27,@Campbell,7,2,Campbell,5
2021-05-28,@Gardner-Webb,9,6,Gardner-Webb,3
2021-05-29,@Campbell,8,5,Campbell,3
2021-06-04,@Vanderbilt,0,10,Vanderbilt,-10
2021-06-05,@Indiana State,2,9,Indiana State,-7
2021-03-05,@Purdue,6,5,Nebraska,1
2021-03-06,@Purdue,2,7,Nebraska,-5
2021-03-06,@Purdue,0,10,Nebraska,-10
2021-03-07,@Purdue,0,4,Nebraska,-4
2021-03-12,@Michigan,1,9,Michigan,-8
2021-03-13,@Michigan,2,9,Michigan,-7
2021-03-13,@Michigan,0,4,Michigan,-4
2021-03-14,@Michigan,6,11,Michigan,-5
2021-03-19,@Indiana,1,2,Indiana,-1
2021-03-20,@Indiana,8,5,Indiana,3
2021-03-21,@Indiana,4,9,Indiana,-5
2021-03-26,@Purdue,5,7,Rutgers,-2
2021-03-27,@Purdue,7,4,Rutgers,3
2021-03-28,@Purdue,4,15,Rutgers,-11
2021-04-02,@Purdue,2,4,Iowa,-2
2021-04-03,@Purdue,10,8,Iowa,2
2021-04-04,@Purdue,5,8,Iowa,-3
2021-04-10,@Purdue,0,11,Penn State,-11
2021-04-11,@Michigan State,2,5,Michigan State,-3
2021-04-11,@Penn State,8,5,Penn State,3
2021-04-12,@Michigan State,8,2,Michigan State,6
2021-04-17,@Purdue,2,1,Michigan State,1
2021-04-18,@Illinois,6,4,Illinois,2
2021-04-18,@Michigan State,8,3,Michigan State,5
2021-04-19,@Illinois,20,6,Illinois,14
2021-04-23,@Purdue,5,6,Illinois,-1
2021-04-24,@Purdue,4,12,Illinois,-8
2021-04-25,@Purdue,0,1,Illinois,-1
2021-04-30,@Ohio State,3,11,Ohio State,-8
2021-05-01,@Ohio State,2,12,Ohio State,-10
2021-05-02,@Ohio State,16,15,Ohio State,1
2021-05-11,@Purdue,1,5,Ohio State,-4
2021-05-14,@Maryland,0,11,Maryland,-11
2021-05-15,@Maryland,1,6,Maryland,-5
2021-05-16,@Maryland,2,7,Maryland,-5
2021-05-20,@Minnesota,9,3,Minnesota,6
2021-05-21,@Minnesota,12,5,Minnesota,7
2021-05-22,@Minnesota,17,4,Minnesota,13
2021-05-23,@Minnesota,8,9,Minnesota,-1
2021-05-29,@Purdue,7,4,Penn State,3
2021-05-30,@Purdue,7,6,Minnesota,1
2021-05-30,@Purdue,1,2,Minnesota,-1
2021-03-20,@Quinnipiac,5,0,Monmouth,5
2021-03-20,@Quinnipiac,5,8,Monmouth,-3
2021-03-21,@Quinnipiac,3,5,Monmouth,-2
2021-03-21,@Quinnipiac,7,11,Monmouth,-4
2021-03-26,@Rider,5,8,Rider,-3
2021-03-26,@Rider,1,2,Rider,-1
2021-03-27,@Rider,8,5,Rider,3
2021-03-27,@Rider,6,12,Rider,-6
2021-04-02,@Niagara,7,8,Niagara,-1
2021-04-02,@Niagara,4,8,Niagara,-4
2021-04-03,@Niagara,3,4,Niagara,-1
2021-04-03,@Niagara,3,6,Niagara,-3
2021-04-07,@Fairfield,3,6,Fairfield,-3
2021-04-07,@Fairfield,6,17,Fairfield,-11
2021-04-09,@Quinnipiac,11,1,Siena,10
2021-04-09,@Quinnipiac,6,10,Siena,-4
2021-04-10,@Quinnipiac,9,5,Siena,4
2021-04-10,@Quinnipiac,6,8,Siena,-2
2021-04-14,@Fairfield,1,2,Fairfield,-1
2021-04-14,@Fairfield,2,5,Fairfield,-3
2021-05-09,@Canisius,1,5,Canisius,-4
2021-05-10,@Canisius,2,1,Canisius,1
2021-05-10,@Canisius,5,15,Canisius,-10
2021-05-10,@Canisius,2,10,Canisius,-8
2021-05-14,@Quinnipiac,5,1,Marist,4
2021-05-14,@Quinnipiac,4,12,Marist,-8
2021-05-15,@Marist,11,9,Marist,2
2021-05-15,@Marist,4,9,Marist,-5
2021-02-19,@Radford,7,3,Ohio,4
2021-02-20,@Radford,4,2,Ohio,2
2021-02-21,@Radford,5,7,Ohio,-2
2021-02-23,@Virginia Tech,2,22,Virginia Tech,-20
2021-02-27,@Radford,5,3,Villanova,2
2021-02-28,@Radford,6,1,Villanova,5
2021-03-02,@Liberty,1,5,Liberty,-4
2021-03-05,@South Carolina-Upstate,6,7,South Carolina-Upstate,-1
2021-03-06,@South Carolina-Upstate,1,6,South Carolina-Upstate,-5
2021-03-06,@South Carolina-Upstate,0,7,South Carolina-Upstate,-7
2021-03-09,@East Tennessee State,0,6,East Tennessee State,-6
2021-03-12,@High Point,3,1,High Point,2
2021-03-13,@High Point,4,2,High Point,2
2021-03-13,@High Point,9,5,High Point,4
2021-03-16,@VMI,12,3,VMI,9
2021-03-19,@Radford,6,7,Presbyterian,-1
2021-03-20,@Radford,12,5,Presbyterian,7
2021-03-23,@Radford,11,3,Longwood,8
2021-03-26,@North Carolina-Asheville,5,6,North Carolina-Asheville,-1
2021-03-26,@North Carolina-Asheville,11,6,North Carolina-Asheville,5
2021-03-27,@North Carolina-Asheville,2,5,North Carolina-Asheville,-3
2021-03-30,@Radford,9,5,East Tennessee State,4
2021-04-02,@Radford,2,3,South Carolina-Upstate,-1
2021-04-03,@Radford,4,5,South Carolina-Upstate,-1
2021-04-03,@Radford,5,2,South Carolina-Upstate,3
2021-04-06,@Radford,7,9,Gardner-Webb,-2
2021-04-16,@Radford,7,9,Winthrop,-2
2021-04-17,@Radford,6,4,Winthrop,2
2021-04-17,@Radford,11,1,Winthrop,10
2021-04-20,@Longwood,16,5,Longwood,11
2021-04-23,@Radford,11,3,High Point,8
2021-04-23,@Radford,5,7,High Point,-2
2021-04-25,@Radford,4,3,High Point,1
2021-04-30,@Longwood,7,10,Longwood,-3
2021-05-01,@Longwood,4,6,Longwood,-2
2021-05-01,@Longwood,3,7,Longwood,-4
2021-05-07,@Radford,6,12,Campbell,-6
2021-05-08,@Radford,1,6,Campbell,-5
2021-05-08,@Radford,4,10,Campbell,-6
2021-05-11,@Gardner-Webb,9,6,Gardner-Webb,3
2021-05-14,@Radford,14,6,Charleston Southern,8
2021-05-15,@Radford,11,3,Charleston Southern,8
2021-05-15,@Radford,6,3,Charleston Southern,3
2021-05-20,@Gardner-Webb,8,10,Gardner-Webb,-2
2021-05-21,@Gardner-Webb,8,4,Gardner-Webb,4
2021-05-21,@Gardner-Webb,5,7,Gardner-Webb,-2
2021-02-19,@East Carolina,2,3,East Carolina,-1
2021-02-20,@East Carolina,1,7,East Carolina,-6
2021-02-21,@East Carolina,4,12,East Carolina,-8
2021-02-26,@Old Dominion,6,4,Old Dominion,2
2021-02-27,@Old Dominion,6,5,Old Dominion,1
2021-02-28,@Old Dominion,3,16,Old Dominion,-13
2021-03-03,@Boston College,4,6,Boston College,-2
2021-03-06,@Rhode Island,3,1,Massachusetts-Lowell,2
2021-03-07,@Rhode Island,5,2,Massachusetts-Lowell,3
2021-03-07,@Rhode Island,4,0,Massachusetts-Lowell,4
2021-03-13,@Rhode Island,7,0,Bryant,7
2021-03-14,@Rhode Island,6,4,Bryant,2
2021-03-17,@Rhode Island,7,3,Sacred Heart,4
2021-03-20,@North Carolina-Charlotte,6,3,North Carolina-Charlotte,3
2021-03-20,@North Carolina-Charlotte,1,2,North Carolina-Charlotte,-1
2021-03-21,@North Carolina-Charlotte,3,6,North Carolina-Charlotte,-3
2021-03-26,@Connecticut,6,9,Connecticut,-3
2021-03-27,@Connecticut,6,4,Connecticut,2
2021-03-27,@Connecticut,2,3,Connecticut,-1
2021-03-30,@Army,2,3,Army,-1
2021-04-02,@Rhode Island,12,11,Hofstra,1
2021-04-03,@Hofstra,1,3,Hofstra,-2
2021-04-03,@Hofstra,4,5,Hofstra,-1
2021-04-07,@Rhode Island,7,10,Bryant,-3
2021-04-09,@LaSalle,5,8,LaSalle,-3
2021-04-10,@LaSalle,12,6,LaSalle,6
2021-04-10,@LaSalle,4,2,LaSalle,2
2021-04-11,@LaSalle,3,7,LaSalle,-4
2021-04-21,@Boston College,6,4,Boston College,2
2021-04-23,@Rhode Island,2,11,Massachusetts,-9
2021-04-23,@Rhode Island,8,7,Massachusetts,1
2021-04-24,@Rhode Island,7,3,Massachusetts,4
2021-04-24,@Rhode Island,10,8,Massachusetts,2
2021-04-30,@Arizona State,6,9,Arizona State,-3
2021-05-01,@Arizona State,6,8,Arizona State,-2
2021-05-02,@Arizona State,13,14,Arizona State,-1
2021-05-07,@St. Bonaventure,8,3,St. Bonaventure,5
2021-05-08,@St. Bonaventure,7,1,St. Bonaventure,6
2021-05-08,@St. Bonaventure,2,3,St. Bonaventure,-1
2021-05-09,@St. Bonaventure,8,4,St. Bonaventure,4
2021-05-11,@Rhode Island,1,8,Army,-7
2021-05-11,@Rhode Island,9,5,Army,4
2021-05-14,@Rhode Island,5,6,St. Joseph's,-1
2021-05-15,@Rhode Island,8,7,St. Joseph's,1
2021-05-15,@Rhode Island,7,3,St. Joseph's,4
2021-05-16,@Rhode Island,3,6,St. Joseph's,-3
2021-05-18,@Rhode Island,6,15,Connecticut,-9
2021-05-20,@Massachusetts,17,6,Massachusetts,11
2021-05-21,@Massachusetts,7,5,Massachusetts,2
2021-05-21,@Massachusetts,7,2,Massachusetts,5
2021-05-22,@Massachusetts,16,1,Massachusetts,15
2021-05-27,@Dayton,8,2,Dayton,6
2021-05-28,@Rhode Island,1,3,Dayton,-2
2021-05-28,@Rhode Island,4,10,Virginia Commonwealth,-6
2021-02-20,@Rice,7,8,Houston Baptist,-1
2021-02-21,@Rice,9,3,Houston Baptist,6
2021-02-22,@Rice,1,0,Houston Baptist,1
2021-02-26,@Louisiana-Lafayette,3,7,Louisiana-Lafayette,-4
2021-02-27,@Louisiana-Lafayette,3,5,Louisiana-Lafayette,-2
2021-02-28,@Louisiana-Lafayette,3,6,Louisiana-Lafayette,-3
2021-03-03,@Rice,10,0,Prairie View A&M,10
2021-03-05,@Rice,4,12,Sam Houston State,-8
2021-03-06,@Texas A&M-Corpus Christi,16,5,Texas A&M-Corpus Christi,11
2021-03-07,@Texas State,1,9,Texas State,-8
2021-03-09,@Rice,3,1,Houston Baptist,2
2021-03-12,@Rice,6,3,Northern Illinois,3
2021-03-13,@Rice,3,8,Kansas State,-5
2021-03-13,@Rice,4,1,Northern Illinois,3
2021-03-14,@Rice,1,0,Kansas State,1
2021-03-17,@Texas State,5,16,Texas State,-11
2021-03-19,@Rice,14,2,Southern,12
2021-03-20,@Rice,13,4,Southern,9
2021-03-21,@Rice,4,6,Southern,-2
2021-03-23,@Texas A&M,2,1,Texas A&M,1
2021-03-26,@Rice,4,16,Texas-San Antonio,-12
2021-03-27,@Rice,1,4,Texas-San Antonio,-3
2021-03-27,@Rice,10,8,Texas-San Antonio,2
2021-03-28,@Rice,3,11,Texas-San Antonio,-8
2021-04-01,@Middle Tennessee State,1,4,Middle Tennessee State,-3
2021-04-02,@Middle Tennessee State,3,4,Middle Tennessee State,-1
2021-04-02,@Middle Tennessee State,4,1,Middle Tennessee State,3
2021-04-09,@Rice,0,6,Louisiana Tech,-6
2021-04-10,@Rice,6,20,Louisiana Tech,-14
2021-04-10,@Rice,6,7,Louisiana Tech,-1
2021-04-11,@Rice,4,13,Louisiana Tech,-9
2021-04-13,@Rice,15,12,Incarnate Word,3
2021-04-16,@Old Dominion,4,11,Old Dominion,-7
2021-04-17,@Old Dominion,11,2,Old Dominion,9
2021-04-17,@Old Dominion,2,11,Old Dominion,-9
2021-04-18,@Old Dominion,1,4,Old Dominion,-3
2021-04-23,@Texas-San Antonio,8,6,Texas-San Antonio,2
2021-04-24,@Texas-San Antonio,5,4,Texas-San Antonio,1
2021-04-24,@Texas-San Antonio,6,12,Texas-San Antonio,-6
2021-04-25,@Texas-San Antonio,4,12,Texas-San Antonio,-8
2021-04-30,@Rice,6,0,Southern Mississippi,6
2021-04-30,@Rice,1,12,Southern Mississippi,-11
2021-05-01,@Rice,1,10,Southern Mississippi,-9
2021-05-02,@Rice,1,8,Southern Mississippi,-7
2021-05-07,@Alabama-Birmingham,6,1,Alabama-Birmingham,5
2021-05-08,@Alabama-Birmingham,7,0,Alabama-Birmingham,7
2021-05-08,@Alabama-Birmingham,1,2,Alabama-Birmingham,-1
2021-05-09,@Alabama-Birmingham,10,5,Alabama-Birmingham,5
2021-05-14,@Rice,6,9,North Carolina-Charlotte,-3
2021-05-15,@Rice,4,6,North Carolina-Charlotte,-2
2021-05-15,@Rice,11,8,North Carolina-Charlotte,3
2021-05-16,@Rice,6,0,North Carolina-Charlotte,6
2021-02-26,@Richmond,2,1,Mount St. Mary's,1
2021-02-26,@Richmond,6,2,Mount St. Mary's,4
2021-02-27,@Richmond,9,8,Mount St. Mary's,1
2021-02-28,@Richmond,7,5,Mount St. Mary's,2
2021-03-05,@George Mason,7,10,George Mason,-3
2021-03-06,@Richmond,10,3,VMI,7
2021-03-08,@Richmond,2,10,Central Michigan,-8
2021-03-09,@Virginia,0,7,Virginia,-7
2021-03-20,@Richmond,3,4,Old Dominion,-1
2021-03-21,@Richmond,12,5,George Mason,7
2021-03-23,@VMI,8,4,VMI,4
2021-03-27,@Richmond,10,5,Longwood,5
2021-03-27,@Richmond,5,4,Longwood,1
2021-03-30,@Richmond,17,5,Norfolk State,12
2021-04-02,@William and Mary,3,4,William and Mary,-1
2021-04-04,@Richmond,5,4,William and Mary,1
2021-04-04,@Richmond,6,10,William and Mary,-4
2021-04-10,@Richmond,10,9,Towson,1
2021-04-10,@Richmond,11,3,Towson,8
2021-04-11,@Towson,14,6,Towson,8
2021-04-30,@Richmond,6,4,Davidson,2
2021-05-01,@Richmond,3,1,Davidson,2
2021-05-01,@Richmond,2,4,Davidson,-2
2021-05-02,@Richmond,7,17,Davidson,-10
2021-05-07,@Richmond,3,8,Dayton,-5
2021-05-08,@Richmond,2,5,Dayton,-3
2021-05-08,@Richmond,2,3,Dayton,-1
2021-05-09,@Richmond,10,20,Dayton,-10
2021-05-14,@George Washington,5,6,George Washington,-1
2021-05-15,@George Washington,5,0,George Washington,5
2021-05-15,@George Washington,5,7,George Washington,-2
2021-05-16,@George Washington,1,3,George Washington,-2
2021-05-20,@George Mason,5,6,George Mason,-1
2021-05-21,@George Mason,2,0,George Mason,2
2021-05-21,@George Mason,5,12,George Mason,-7
2021-05-22,@George Mason,11,1,George Mason,10
2021-03-20,@Rider,11,5,Niagara,6
2021-03-20,@Rider,1,0,Niagara,1
2021-03-21,@Rider,3,8,Niagara,-5
2021-03-21,@Rider,9,0,Niagara,9
2021-03-26,@Rider,2,1,Quinnipiac,1
2021-03-26,@Rider,8,5,Quinnipiac,3
2021-03-27,@Rider,5,8,Quinnipiac,-3
2021-03-27,@Rider,12,6,Quinnipiac,6
2021-04-02,@Manhattan,1,8,Manhattan,-7
2021-04-02,@Manhattan,10,2,Manhattan,8
2021-04-03,@Manhattan,6,1,Manhattan,5
2021-04-03,@Manhattan,9,3,Manhattan,6
2021-04-07,@Monmouth,13,7,Monmouth,6
2021-04-07,@Monmouth,1,3,Monmouth,-2
2021-04-09,@Fairfield,3,8,Fairfield,-5
2021-04-09,@Fairfield,0,10,Fairfield,-10
2021-04-10,@Fairfield,0,6,Fairfield,-6
2021-04-10,@Fairfield,0,5,Fairfield,-5
2021-04-14,@Monmouth,1,0,Monmouth,1
2021-04-14,@Monmouth,1,11,Monmouth,-10
2021-04-25,@Canisius,4,3,Canisius,1
2021-04-25,@Canisius,0,8,Canisius,-8
2021-04-26,@Canisius,5,2,Canisius,3
2021-04-26,@Canisius,4,5,Canisius,-1
2021-04-28,@Rider,5,8,Marist,-3
2021-04-28,@Rider,3,10,Marist,-7
2021-05-01,@Rider,5,0,St. Peter's,5
2021-05-01,@Rider,12,2,St. Peter's,10
2021-05-02,@Rider,17,3,St. Peter's,14
2021-05-02,@Rider,14,1,St. Peter's,13
2021-05-08,@Siena,0,3,Siena,-3
2021-05-08,@Siena,1,0,Siena,1
2021-05-09,@Siena,0,4,Siena,-4
2021-05-09,@Siena,3,9,Siena,-6
2021-05-20,@Rider,8,5,Niagara,3
2021-05-20,@Rider,12,4,Niagara,8
2021-05-26,@Monmouth,9,5,Monmouth,4
2021-05-27,@Rider,4,3,Canisius,1
2021-05-28,@Fairfield,7,2,Fairfield,5
2021-06-04,@Louisiana Tech,2,18,Louisiana Tech,-16
2021-06-05,@Alabama,1,3,Alabama,-2
2021-03-05,@Rutgers,2,1,Indiana,1
2021-03-06,@Indiana,2,4,Indiana,-2
2021-03-06,@Minnesota,16,1,Minnesota,15
2021-03-07,@Minnesota,8,13,Minnesota,-5
2021-03-12,@Maryland,8,13,Maryland,-5
2021-03-13,@Maryland,8,7,Maryland,1
2021-03-13,@Maryland,9,3,Maryland,6
2021-03-14,@Maryland,5,9,Maryland,-4
2021-03-20,@Rutgers,6,5,Ohio State,1
2021-03-21,@Rutgers,2,0,Ohio State,2
2021-03-22,@Rutgers,1,4,Ohio State,-3
2021-03-26,@Purdue,7,5,Purdue,2
2021-03-27,@Purdue,4,7,Purdue,-3
2021-03-28,@Purdue,15,4,Purdue,11
2021-04-02,@Rutgers,0,1,Penn State,-1
2021-04-03,@Rutgers,1,5,Penn State,-4
2021-04-04,@Rutgers,6,4,Penn State,2
2021-04-09,@Northwestern,5,6,Northwestern,-1
2021-04-10,@Northwestern,8,4,Northwestern,4
2021-04-11,@Northwestern,6,5,Northwestern,1
2021-04-16,@Rutgers,12,14,Iowa,-2
2021-04-17,@Rutgers,1,8,Iowa,-7
2021-04-17,@Rutgers,1,3,Iowa,-2
2021-04-18,@Rutgers,8,7,Iowa,1
2021-04-23,@Michigan,4,6,Michigan,-2
2021-04-24,@Michigan,4,2,Michigan,2
2021-04-25,@Michigan,3,2,Michigan,1
2021-04-30,@Nebraska,9,4,Nebraska,5
2021-05-01,@Nebraska,6,5,Nebraska,1
2021-05-02,@Nebraska,6,0,Nebraska,6
2021-05-07,@Rutgers,3,8,Indiana,-5
2021-05-08,@Rutgers,3,5,Indiana,-2
2021-05-09,@Rutgers,5,15,Nebraska,-10
2021-05-10,@Rutgers,6,7,Nebraska,-1
2021-05-14,@Penn State,3,7,Penn State,-4
2021-05-15,@Penn State,3,4,Penn State,-1
2021-05-16,@Penn State,5,0,Penn State,5
2021-05-17,@Penn State,6,8,Penn State,-2
2021-05-21,@Rutgers,1,12,Michigan State,-11
2021-05-22,@Rutgers,15,8,Michigan State,7
2021-05-23,@Rutgers,8,14,Michigan State,-6
2021-05-28,@Rutgers,3,2,Illinois,1
2021-05-29,@Rutgers,6,3,Illinois,3
2021-05-29,@Rutgers,1,13,Illinois,-12
2021-02-19,@Arizona State,4,2,Arizona State,2
2021-02-20,@Arizona State,1,2,Arizona State,-1
2021-02-21,@Arizona State,1,3,Arizona State,-2
2021-02-27,@Sacramento State,8,4,Texas State,4
2021-02-27,@Sacramento State,5,4,Texas State,1
2021-02-28,@Sacramento State,7,1,Texas State,6
2021-03-01,@Sacramento State,8,5,Pacific,3
2021-03-04,@Santa Clara,0,5,Santa Clara,-5
2021-03-05,@Santa Clara,2,1,Santa Clara,1
2021-03-06,@Santa Clara,10,0,Santa Clara,10
2021-03-07,@Santa Clara,6,10,Santa Clara,-4
2021-03-12,@Tarleton State,17,3,Tarleton State,14
2021-03-12,@Tarleton State,6,0,Tarleton State,6
2021-03-13,@Tarleton State,13,16,Tarleton State,-3
2021-03-14,@Tarleton State,20,5,Tarleton State,15
2021-03-19,@Utah Valley,8,5,Utah Valley,3
2021-03-19,@Utah Valley,8,3,Utah Valley,5
2021-03-21,@Utah Valley,10,4,Utah Valley,6
2021-03-21,@Utah Valley,11,7,Utah Valley,4
2021-03-26,@Sacramento State,9,3,Dixie State,6
2021-03-27,@Sacramento State,9,4,Dixie State,5
2021-03-27,@Sacramento State,10,5,Dixie State,5
2021-03-28,@Sacramento State,5,7,Dixie State,-2
2021-03-29,@Sacramento State,3,2,Stanford,1
2021-04-09,@Sacramento State,2,10,New Mexico State,-8
2021-04-09,@Sacramento State,10,5,New Mexico State,5
2021-04-10,@Sacramento State,9,6,New Mexico State,3
2021-04-11,@Sacramento State,4,0,New Mexico State,4
2021-04-16,@Sacramento State,0,6,Seattle,-6
2021-04-17,@Sacramento State,0,5,Seattle,-5
2021-04-17,@Sacramento State,0,3,Seattle,-3
2021-04-18,@Sacramento State,11,4,Seattle,7
2021-04-23,@Northern Colorado,4,2,Northern Colorado,2
2021-04-24,@Northern Colorado,10,1,Northern Colorado,9
2021-04-24,@Northern Colorado,6,8,Northern Colorado,-2
2021-04-25,@Northern Colorado,11,13,Northern Colorado,-2
2021-04-27,@Kansas,11,6,Kansas,5
2021-04-28,@Kansas,4,6,Kansas,-2
2021-04-30,@Sacramento State,5,15,Grand Canyon,-10
2021-05-01,@Sacramento State,0,12,Grand Canyon,-12
2021-05-01,@Sacramento State,1,6,Grand Canyon,-5
2021-05-02,@Sacramento State,3,2,Grand Canyon,1
2021-05-07,@California Baptist,14,11,California Baptist,3
2021-05-08,@California Baptist,1,6,California Baptist,-5
2021-05-08,@California Baptist,6,7,California Baptist,-1
2021-05-09,@California Baptist,14,1,California Baptist,13
2021-05-14,@San Francisco,2,1,San Francisco,1
2021-05-15,@Sacramento State,7,6,San Francisco,1
2021-05-15,@Sacramento State,0,8,San Francisco,-8
2021-05-16,@San Francisco,4,0,San Francisco,4
2021-05-20,@Sacramento State,5,4,Texas-Rio Grande Valley,1
2021-05-21,@Sacramento State,6,5,Texas-Rio Grande Valley,1
2021-05-21,@Sacramento State,20,5,Texas-Rio Grande Valley,15
2021-05-22,@Sacramento State,2,4,Texas-Rio Grande Valley,-2
2021-05-27,@Sacramento State,9,5,Texas-Rio Grande Valley,4
2021-05-28,@Grand Canyon,0,11,Grand Canyon,-11
2021-05-29,@Texas-Rio Grande Valley,0,10,Texas-Rio Grande Valley,-10
2021-02-26,@Stony Brook,0,1,Stony Brook,-1
2021-02-26,@Stony Brook,1,7,Stony Brook,-6
2021-02-28,@Stony Brook,2,0,Stony Brook,2
2021-03-05,@St. John's,2,8,St. John's,-6
2021-03-06,@St. John's,4,16,St. John's,-12
2021-03-07,@St. John's,1,12,St. John's,-11
2021-03-07,@St. John's,2,11,St. John's,-9
2021-03-10,@Fordham,0,10,Fordham,-10
2021-03-12,@Hofstra,5,8,Hofstra,-3
2021-03-13,@Hofstra,7,27,Hofstra,-20
2021-03-13,@Hofstra,4,3,Hofstra,1
2021-03-14,@Hofstra,0,5,Hofstra,-5
2021-03-17,@Rhode Island,3,7,Rhode Island,-4
2021-03-19,@Central Connecticut State,0,6,Central Connecticut State,-6
2021-03-20,@Central Connecticut State,2,4,Central Connecticut State,-2
2021-03-21,@Central Connecticut State,3,2,Central Connecticut State,1
2021-03-24,@Sacred Heart,10,4,Fordham,6
2021-03-26,@Wagner,15,8,Wagner,7
2021-03-27,@Wagner,13,3,Wagner,10
2021-03-27,@Wagner,5,2,Wagner,3
2021-03-30,@LIU-Brooklyn,9,7,LIU-Brooklyn,2
2021-04-01,@Sacred Heart,3,4,Merrimack,-1
2021-04-02,@Sacred Heart,1,2,Merrimack,-1
2021-04-03,@Sacred Heart,9,6,Merrimack,3
2021-04-06,@Sacred Heart,8,7,LIU-Brooklyn,1
2021-04-09,@Mount St. Mary's,8,5,Mount St. Mary's,3
2021-04-10,@Mount St. Mary's,14,7,Mount St. Mary's,7
2021-04-11,@Mount St. Mary's,6,4,Mount St. Mary's,2
2021-04-24,@LIU-Brooklyn,3,5,LIU-Brooklyn,-2
2021-04-24,@LIU-Brooklyn,9,3,LIU-Brooklyn,6
2021-04-26,@LIU-Brooklyn,2,3,LIU-Brooklyn,-1
2021-04-27,@Sacred Heart,6,8,Massachusetts,-2
2021-04-30,@Sacred Heart,12,7,Fairleigh Dickinson,5
2021-05-01,@Sacred Heart,14,4,Fairleigh Dickinson,10
2021-05-02,@Sacred Heart,7,3,Fairleigh Dickinson,4
2021-05-04,@Army,4,9,Army,-5
2021-05-07,@Sacred Heart,3,11,Central Connecticut State,-8
2021-05-08,@Sacred Heart,4,3,Central Connecticut State,1
2021-05-09,@Sacred Heart,2,1,Central Connecticut State,1
2021-05-14,@Merrimack,1,5,Merrimack,-4
2021-05-15,@Merrimack,3,15,Merrimack,-12
2021-05-16,@Merrimack,9,3,Merrimack,6
2021-05-21,@Sacred Heart,3,2,Wagner,1
2021-05-21,@Sacred Heart,7,9,Wagner,-2
2021-05-22,@Sacred Heart,14,6,Wagner,8
2021-05-27,@Central Connecticut State,10,17,Central Connecticut State,-7
2021-05-28,@LIU-Brooklyn,5,4,LIU-Brooklyn,1
2021-05-29,@Sacred Heart,3,5,Central Connecticut State,-2
2021-02-24,@Texas State,4,5,Texas State,-1
2021-02-26,@Sam Houston State,4,2,Texas-San Antonio,2
2021-02-27,@Sam Houston State,4,10,Texas-San Antonio,-6
2021-02-28,@Sam Houston State,5,18,Texas-San Antonio,-13
2021-03-02,@Baylor,0,4,Baylor,-4
2021-03-05,@Rice,12,4,Rice,8
2021-03-06,@Sam Houston State,0,8,Texas Tech,-8
2021-03-07,@Sam Houston State,6,5,Texas Christian,1
2021-03-09,@Texas,9,15,Texas,-6
2021-03-12,@Southeastern Louisiana,3,12,Southeastern Louisiana,-9
2021-03-13,@Southeastern Louisiana,6,7,Southeastern Louisiana,-1
2021-03-13,@Southeastern Louisiana,2,3,Southeastern Louisiana,-1
2021-03-14,@Southeastern Louisiana,1,3,Southeastern Louisiana,-2
2021-03-19,@Sam Houston State,3,2,Northwestern State,1
2021-03-20,@Sam Houston State,1,3,Northwestern State,-2
2021-03-20,@Sam Houston State,2,3,Northwestern State,-1
2021-03-21,@Sam Houston State,6,3,Northwestern State,3
2021-03-26,@Sam Houston State,13,2,Texas A&M-Corpus Christi,11
2021-03-27,@Sam Houston State,9,4,Texas A&M-Corpus Christi,5
2021-03-27,@Sam Houston State,6,12,Texas A&M-Corpus Christi,-6
2021-03-28,@Sam Houston State,7,6,Texas A&M-Corpus Christi,1
2021-04-01,@Central Arkansas,3,2,Central Arkansas,1
2021-04-02,@Central Arkansas,2,0,Central Arkansas,2
2021-04-02,@Central Arkansas,3,1,Central Arkansas,2
2021-04-03,@Central Arkansas,10,4,Central Arkansas,6
2021-04-06,@Sam Houston State,8,6,Texas A&M,2
2021-04-09,@New Orleans,7,9,New Orleans,-2
2021-04-09,@New Orleans,13,4,New Orleans,9
2021-04-10,@New Orleans,13,20,New Orleans,-7
2021-04-11,@New Orleans,7,1,New Orleans,6
2021-04-13,@Sam Houston State,1,4,Baylor,-3
2021-04-17,@Sam Houston State,6,5,McNeese State,1
2021-04-17,@Sam Houston State,6,2,McNeese State,4
2021-04-18,@Sam Houston State,6,4,McNeese State,2
2021-04-18,@Sam Houston State,5,4,McNeese State,1
2021-04-30,@Stephen F. Austin State,3,6,Stephen F. Austin State,-3
2021-05-01,@Stephen F. Austin State,4,5,Stephen F. Austin State,-1
2021-05-01,@Stephen F. Austin State,9,3,Stephen F. Austin State,6
2021-05-07,@Sam Houston State,3,5,Arkansas-Little Rock,-2
2021-05-08,@Sam Houston State,9,4,Arkansas-Little Rock,5
2021-05-09,@Sam Houston State,8,4,Arkansas-Little Rock,4
2021-05-14,@Sam Houston State,1,10,Abilene Christian,-9
2021-05-15,@Sam Houston State,6,12,Abilene Christian,-6
2021-05-15,@Sam Houston State,5,4,Abilene Christian,1
2021-05-16,@Sam Houston State,3,5,Abilene Christian,-2
2021-05-21,@Nicholls State,16,3,Nicholls State,13
2021-05-21,@Nicholls State,11,4,Nicholls State,7
2021-05-22,@Nicholls State,4,5,Nicholls State,-1
2021-05-22,@Nicholls State,5,4,Nicholls State,1
2021-05-26,@Texas A&M-Corpus Christi,3,4,Texas A&M-Corpus Christi,-1
2021-05-27,@Sam Houston State,7,4,Lamar,3
2021-05-28,@Sam Houston State,14,12,Abilene Christian,2
2021-05-28,@Texas A&M-Corpus Christi,14,2,Texas A&M-Corpus Christi,12
2021-05-29,@Abilene Christian,15,13,Abilene Christian,2
2021-05-29,@McNeese State,1,2,McNeese State,-1
2021-02-19,@Samford,5,3,Tennessee-Martin,2
2021-02-20,@Samford,5,4,Tennessee-Martin,1
2021-02-21,@Samford,3,1,Tennessee-Martin,2
2021-02-23,@Samford,9,11,Alabama State,-2
2021-02-26,@Florida,4,8,Florida,-4
2021-02-27,@Florida,2,18,Florida,-16
2021-02-28,@Florida,9,10,Florida,-1
2021-03-03,@Samford,10,9,Jacksonville State,1
2021-03-05,@Samford,9,4,Toledo,5
2021-03-06,@Samford,3,14,Toledo,-11
2021-03-07,@Samford,16,8,Toledo,8
2021-03-09,@Troy,6,5,Troy,1
2021-03-10,@Alabama State,3,11,Alabama State,-8
2021-03-12,@Texas A&M,1,10,Texas A&M,-9
2021-03-13,@Texas A&M,2,5,Texas A&M,-3
2021-03-13,@Texas A&M,4,21,Texas A&M,-17
2021-03-16,@Mississippi State,2,10,Mississippi State,-8
2021-03-20,@North Carolina-Greensboro,6,1,North Carolina-Greensboro,5
2021-03-20,@North Carolina-Greensboro,12,5,North Carolina-Greensboro,7
2021-03-21,@North Carolina-Greensboro,8,3,North Carolina-Greensboro,5
2021-03-23,@Alabama-Birmingham,5,1,Alabama-Birmingham,4
2021-03-26,@Samford,7,3,East Tennessee State,4
2021-03-26,@Samford,10,2,East Tennessee State,8
2021-03-27,@Samford,1,5,East Tennessee State,-4
2021-03-30,@Jacksonville State,5,4,Jacksonville State,1
2021-04-02,@Samford,11,4,VMI,7
2021-04-02,@Samford,7,6,VMI,1
2021-04-03,@Samford,7,6,VMI,1
2021-04-06,@Samford,4,3,Troy,1
2021-04-10,@Samford,12,11,The Citadel,1
2021-04-10,@Samford,14,1,The Citadel,13
2021-04-11,@Samford,8,4,The Citadel,4
2021-04-13,@Alabama,3,19,Alabama,-16
2021-04-16,@Western Carolina,8,5,Western Carolina,3
2021-04-16,@Western Carolina,2,7,Western Carolina,-5
2021-04-17,@Western Carolina,11,12,Western Carolina,-1
2021-04-20,@Auburn,4,6,Auburn,-2
2021-04-23,@Samford,5,12,Mercer,-7
2021-04-23,@Samford,10,9,Mercer,1
2021-04-24,@Samford,4,5,Mercer,-1
2021-04-30,@Wofford,9,8,Wofford,1
2021-05-01,@Wofford,5,7,Wofford,-2
2021-05-01,@Wofford,6,7,Wofford,-1
2021-05-07,@VMI,25,1,VMI,24
2021-05-07,@VMI,11,5,VMI,6
2021-05-08,@VMI,18,1,VMI,17
2021-05-12,@Samford,6,1,Auburn,5
2021-05-14,@Samford,4,11,North Carolina-Greensboro,-7
2021-05-14,@Samford,8,3,North Carolina-Greensboro,5
2021-05-15,@Samford,8,4,North Carolina-Greensboro,4
2021-05-18,@Samford,9,4,Alabama-Birmingham,5
2021-05-20,@East Tennessee State,1,11,East Tennessee State,-10
2021-05-21,@East Tennessee State,7,6,East Tennessee State,1
2021-05-21,@East Tennessee State,3,7,East Tennessee State,-4
2021-05-27,@Samford,10,8,Mercer,2
2021-05-29,@Samford,19,7,Western Carolina,12
2021-05-30,@Samford,8,6,Western Carolina,2
2021-06-04,@Mississippi State,4,8,Mississippi State,-4
2021-06-05,@Campbell,13,16,Campbell,-3
2021-02-19,@San Diego State,7,14,San Diego State,-7
2021-02-20,@San Diego State,18,19,San Diego State,-1
2021-02-21,@San Diego,16,12,San Diego State,4
2021-02-26,@San Diego,6,1,Cal State Fullerton,5
2021-02-27,@San Diego,6,5,Cal State Fullerton,1
2021-02-28,@San Diego,1,5,Cal State Fullerton,-4
2021-03-04,@UC San Diego,12,4,UC San Diego,8
2021-03-05,@UC San Diego,15,10,UC San Diego,5
2021-03-06,@San Diego,10,2,UC San Diego,8
2021-03-07,@San Diego,8,2,UC San Diego,6
2021-03-12,@San Diego,16,4,UC Riverside,12
2021-03-13,@San Diego,7,0,UC Riverside,7
2021-03-13,@San Diego,9,0,UC Riverside,9
2021-03-14,@San Diego,5,4,UC Riverside,1
2021-03-19,@St. Mary's,7,0,St. Mary's,7
2021-03-20,@St. Mary's,3,4,St. Mary's,-1
2021-03-21,@St. Mary's,5,4,St. Mary's,1
2021-03-23,@Southern California,6,5,Southern California,1
2021-03-26,@San Diego,3,1,Pacific,2
2021-03-27,@San Diego,15,3,Pacific,12
2021-03-28,@San Diego,5,1,Pacific,4
2021-03-30,@San Diego,10,4,Vanguard (CA),6
2021-04-02,@Cal State Fullerton,1,3,Cal State Fullerton,-2
2021-04-03,@San Diego,8,2,Cal State Fullerton,6
2021-04-09,@Loyola Marymount,5,9,Loyola Marymount,-4
2021-04-10,@Loyola Marymount,6,0,Loyola Marymount,6
2021-04-11,@Loyola Marymount,2,4,Loyola Marymount,-2
2021-04-16,@San Diego,1,12,San Francisco,-11
2021-04-17,@San Diego,7,5,San Francisco,2
2021-04-18,@San Diego,8,1,San Francisco,7
2021-04-23,@Santa Clara,2,1,Santa Clara,1
2021-04-24,@Santa Clara,9,4,Santa Clara,5
2021-04-25,@Santa Clara,6,4,Santa Clara,2
2021-04-30,@San Diego,8,3,Pepperdine,5
2021-05-01,@San Diego,7,6,Pepperdine,1
2021-05-02,@San Diego,10,9,Pepperdine,1
2021-05-06,@San Diego,4,6,Brigham Young,-2
2021-05-07,@San Diego,10,11,Brigham Young,-1
2021-05-08,@San Diego,13,12,Brigham Young,1
2021-05-20,@San Diego,7,1,Portland,6
2021-05-21,@San Diego,4,3,Portland,1
2021-05-22,@San Diego,2,6,Portland,-4
2021-05-27,@Gonzaga,0,10,Gonzaga,-10
2021-05-28,@Gonzaga,9,0,Gonzaga,9
2021-05-29,@Gonzaga,10,2,Gonzaga,8
2021-02-19,@San Diego State,14,7,San Diego,7
2021-02-20,@San Diego State,19,18,San Diego,1
2021-02-21,@San Diego,12,16,San Diego,-4
2021-02-26,@San Diego State,10,4,UC San Diego,6
2021-02-27,@San Diego State,3,9,UC San Diego,-6
2021-02-28,@UC San Diego,13,6,UC San Diego,7
2021-02-28,@UC San Diego,7,5,UC San Diego,2
2021-03-06,@San Diego State,17,0,Fresno State,17
2021-03-06,@San Diego State,2,3,Fresno State,-1
2021-03-07,@San Diego State,12,7,Fresno State,5
2021-03-13,@San Diego State,1,5,Nevada-Las Vegas,-4
2021-03-13,@San Diego State,3,1,Nevada-Las Vegas,2
2021-03-14,@San Diego State,8,6,Nevada-Las Vegas,2
2021-03-20,@San Diego State,5,1,Air Force,4
2021-03-20,@San Diego State,9,2,Air Force,7
2021-03-21,@San Diego State,9,13,Air Force,-4
2021-03-27,@San Jose State,6,4,San Jose State,2
2021-03-27,@San Jose State,7,12,San Jose State,-5
2021-03-28,@San Jose State,14,4,San Jose State,10
2021-04-02,@San Diego State,10,9,New Mexico,1
2021-04-02,@San Diego State,5,4,New Mexico,1
2021-04-03,@San Diego State,15,0,New Mexico,15
2021-04-10,@San Diego State,6,10,Nevada,-4
2021-04-10,@San Diego State,15,7,Nevada,8
2021-04-11,@San Diego State,3,5,Nevada,-2
2021-04-17,@Fresno State,3,5,Fresno State,-2
2021-04-17,@Fresno State,12,11,Fresno State,1
2021-04-18,@Fresno State,21,14,Fresno State,7
2021-04-24,@San Diego State,8,7,Dixie State,1
2021-04-24,@San Diego State,5,4,Dixie State,1
2021-04-25,@San Diego State,9,1,Dixie State,8
2021-04-30,@Nevada,2,13,Nevada,-11
2021-04-30,@Nevada,4,14,Nevada,-10
2021-05-01,@Nevada,7,15,Nevada,-8
2021-05-08,@San Diego State,10,6,San Jose State,4
2021-05-08,@San Diego State,17,3,San Jose State,14
2021-05-09,@San Diego State,8,3,San Jose State,5
2021-05-15,@Nevada-Las Vegas,10,11,Nevada-Las Vegas,-1
2021-05-15,@Nevada-Las Vegas,4,14,Nevada-Las Vegas,-10
2021-05-16,@Nevada-Las Vegas,1,8,Nevada-Las Vegas,-7
2021-05-22,@Air Force,17,3,Air Force,14
2021-05-23,@Air Force,20,13,Air Force,7
2021-05-23,@Air Force,13,10,Air Force,3
2021-05-28,@New Mexico,6,5,New Mexico,1
2021-05-28,@New Mexico,7,17,New Mexico,-10
2021-05-29,@New Mexico,11,10,New Mexico,1
2021-02-19,@UCLA,6,2,UCLA,4
2021-02-20,@UCLA,2,8,UCLA,-6
2021-02-21,@UCLA,8,3,UCLA,5
2021-02-25,@California,2,4,California,-2
2021-02-26,@California,3,4,California,-1
2021-02-27,@San Francisco,10,6,California,4
2021-02-28,@San Francisco,1,5,California,-4
2021-03-02,@San Francisco,7,6,Fresno State,1
2021-03-04,@Stanford,6,7,Stanford,-1
2021-03-05,@Stanford,2,3,Stanford,-1
2021-03-06,@San Francisco,6,10,Stanford,-4
2021-03-07,@San Francisco,13,15,Stanford,-2
2021-03-13,@UC Santa Barbara,8,9,UC Santa Barbara,-1
2021-03-13,@UC Santa Barbara,3,15,UC Santa Barbara,-12
2021-03-14,@UC Santa Barbara,2,6,UC Santa Barbara,-4
2021-03-16,@St. Mary's,5,7,St. Mary's,-2
2021-03-19,@San Francisco,2,16,Pepperdine,-14
2021-03-20,@San Francisco,7,6,Pepperdine,1
2021-03-21,@San Francisco,8,10,Pepperdine,-2
2021-03-25,@Brigham Young,7,8,Brigham Young,-1
2021-03-26,@Brigham Young,10,6,Brigham Young,4
2021-03-27,@Brigham Young,3,1,Brigham Young,2
2021-04-01,@San Francisco,4,3,Loyola Marymount,1
2021-04-02,@San Francisco,8,6,Loyola Marymount,2
2021-04-03,@San Francisco,9,4,Loyola Marymount,5
2021-04-06,@San Francisco,7,1,San Jose State,6
2021-04-09,@Santa Clara,4,1,Santa Clara,3
2021-04-10,@Santa Clara,7,6,Santa Clara,1
2021-04-11,@Santa Clara,7,9,Santa Clara,-2
2021-04-16,@San Diego,12,1,San Diego,11
2021-04-17,@San Diego,5,7,San Diego,-2
2021-04-18,@San Diego,1,8,San Diego,-7
2021-04-23,@San Francisco,5,0,Portland,5
2021-04-24,@San Francisco,4,5,Portland,-1
2021-04-24,@San Francisco,6,4,Portland,2
2021-04-30,@Pacific,7,8,Pacific,-1
2021-05-01,@Pacific,6,4,Pacific,2
2021-05-02,@Pacific,17,4,Pacific,13
2021-05-07,@San Francisco,5,4,St. Mary's,1
2021-05-08,@San Francisco,4,6,St. Mary's,-2
2021-05-09,@San Francisco,6,2,St. Mary's,4
2021-05-10,@St. Mary's,4,5,St. Mary's,-1
2021-05-14,@San Francisco,1,2,Sacramento State,-1
2021-05-15,@Sacramento State,8,0,Sacramento State,8
2021-05-15,@Sacramento State,6,7,Sacramento State,-1
2021-05-16,@San Francisco,0,4,Sacramento State,-4
2021-05-18,@San Jose State,9,8,San Jose State,1
2021-05-21,@Gonzaga,2,3,Gonzaga,-1
2021-05-22,@Gonzaga,5,6,Gonzaga,-1
2021-05-23,@Gonzaga,11,1,Gonzaga,10
2021-05-28,@San Francisco,5,1,Santa Clara,4
2021-05-29,@Santa Clara,10,6,Santa Clara,4
2021-05-30,@San Francisco,1,3,Santa Clara,-2
2021-03-27,@San Jose State,12,7,San Diego State,5
2021-03-27,@San Jose State,4,6,San Diego State,-2
2021-03-28,@San Jose State,4,14,San Diego State,-10
2021-03-30,@San Jose State,10,7,California,3
2021-04-01,@Cal Poly,1,10,Cal Poly,-9
2021-04-02,@Cal Poly,10,2,Cal Poly,8
2021-04-03,@Cal Poly,0,3,Cal Poly,-3
2021-04-06,@San Francisco,1,7,San Francisco,-6
2021-04-17,@Creighton,0,5,Creighton,-5
2021-04-18,@Creighton,4,6,Creighton,-2
2021-04-23,@San Jose State,5,4,Fresno State,1
2021-04-24,@San Jose State,2,12,Fresno State,-10
2021-04-24,@San Jose State,2,4,Fresno State,-2
2021-04-25,@San Jose State,7,8,Fresno State,-1
2021-04-27,@Oregon,7,11,Oregon,-4
2021-04-28,@Oregon,1,13,Oregon,-12
2021-05-01,@UC Davis,4,3,UC Davis,1
2021-05-01,@UC Davis,2,12,UC Davis,-10
2021-05-02,@UC Davis,14,11,UC Davis,3
2021-05-04,@California,10,18,California,-8
2021-05-08,@San Diego State,6,10,San Diego State,-4
2021-05-08,@San Diego State,3,17,San Diego State,-14
2021-05-09,@San Diego State,3,8,San Diego State,-5
2021-05-11,@Stanford,7,8,Stanford,-1
2021-05-14,@Air Force,6,11,Air Force,-5
2021-05-15,@Air Force,3,9,Air Force,-6
2021-05-15,@Air Force,3,11,Air Force,-8
2021-05-16,@Air Force,3,5,Air Force,-2
2021-05-18,@San Jose State,8,9,San Francisco,-1
2021-05-22,@San Jose State,2,14,New Mexico,-12
2021-05-22,@San Jose State,2,6,New Mexico,-4
2021-05-23,@San Jose State,4,8,New Mexico,-4
2021-05-28,@Nevada,6,16,Nevada,-10
2021-05-29,@Nevada,10,14,Nevada,-4
2021-05-29,@Nevada,2,7,Nevada,-5
2021-05-30,@Nevada,2,12,Nevada,-10
2021-02-19,@UC Santa Barbara,8,4,UC Santa Barbara,4
2021-02-20,@UC Santa Barbara,6,9,UC Santa Barbara,-3
2021-02-21,@UC Santa Barbara,4,5,UC Santa Barbara,-1
2021-02-25,@Stanford,7,10,Stanford,-3
2021-02-26,@Santa Clara,0,8,Stanford,-8
2021-02-27,@Stanford,6,10,Stanford,-4
2021-02-28,@Santa Clara,13,0,Stanford,13
2021-03-04,@Santa Clara,5,0,Sacramento State,5
2021-03-05,@Santa Clara,1,2,Sacramento State,-1
2021-03-06,@Santa Clara,0,10,Sacramento State,-10
2021-03-07,@Santa Clara,10,6,Sacramento State,4
2021-03-11,@UC San Diego,6,4,UC San Diego,2
2021-03-12,@UC San Diego,1,3,UC San Diego,-2
2021-03-13,@UC San Diego,13,6,UC San Diego,7
2021-03-14,@UC San Diego,9,10,UC San Diego,-1
2021-03-19,@Santa Clara,0,2,Gonzaga,-2
2021-03-20,@Santa Clara,4,10,Gonzaga,-6
2021-03-21,@Santa Clara,2,5,Gonzaga,-3
2021-03-23,@Oregon State,10,9,Oregon State,1
2021-03-24,@Oregon State,0,9,Oregon State,-9
2021-03-26,@Portland,2,3,Portland,-1
2021-03-27,@Portland,8,2,Portland,6
2021-03-28,@Portland,4,2,Portland,2
2021-04-01,@Santa Clara,5,0,Brigham Young,5
2021-04-02,@Santa Clara,11,3,Brigham Young,8
2021-04-03,@Santa Clara,1,3,Brigham Young,-2
2021-04-09,@Santa Clara,1,4,San Francisco,-3
2021-04-10,@Santa Clara,6,7,San Francisco,-1
2021-04-11,@Santa Clara,9,7,San Francisco,2
2021-04-16,@St. Mary's,3,7,St. Mary's,-4
2021-04-17,@St. Mary's,1,2,St. Mary's,-1
2021-04-18,@St. Mary's,2,8,St. Mary's,-6
2021-04-23,@Santa Clara,1,2,San Diego,-1
2021-04-24,@Santa Clara,4,9,San Diego,-5
2021-04-25,@Santa Clara,4,6,San Diego,-2
2021-04-30,@Loyola Marymount,2,5,Loyola Marymount,-3
2021-05-01,@Loyola Marymount,1,3,Loyola Marymount,-2
2021-05-02,@Loyola Marymount,11,7,Loyola Marymount,4
2021-05-07,@Santa Clara,7,11,Pacific,-4
2021-05-08,@Santa Clara,7,6,Pacific,1
2021-05-09,@Santa Clara,3,11,Pacific,-8
2021-05-14,@Pepperdine,11,0,Pepperdine,11
2021-05-15,@Pepperdine,4,8,Pepperdine,-4
2021-05-16,@Pepperdine,2,3,Pepperdine,-1
2021-05-21,@St. Mary's,2,3,St. Mary's,-1
2021-05-22,@Santa Clara,5,3,St. Mary's,2
2021-05-22,@Santa Clara,5,2,St. Mary's,3
2021-05-23,@Santa Clara,4,8,St. Mary's,-4
2021-05-28,@San Francisco,1,5,San Francisco,-4
2021-05-29,@Santa Clara,6,10,San Francisco,-4
2021-05-30,@San Francisco,3,1,San Francisco,2
2021-02-21,@Portland,5,4,Portland,1
2021-02-21,@Portland,0,7,Portland,-7
2021-02-22,@Portland,5,3,Portland,2
2021-02-25,@Oregon,3,4,Oregon,-1
2021-02-26,@Oregon,0,6,Oregon,-6
2021-02-27,@Oregon,4,2,Oregon,2
2021-02-28,@Oregon,8,4,Oregon,4
2021-03-05,@Washington State,1,6,Washington State,-5
2021-03-06,@Washington State,7,14,Washington State,-7
2021-03-07,@Washington State,6,2,Washington State,4
2021-03-11,@Washington,3,7,Washington,-4
2021-03-12,@Washington,3,4,Washington,-1
2021-03-13,@Washington,4,6,Washington,-2
2021-03-19,@Grand Canyon,3,5,Grand Canyon,-2
2021-03-20,@Grand Canyon,2,9,Grand Canyon,-7
2021-03-20,@Grand Canyon,8,9,Grand Canyon,-1
2021-03-21,@Grand Canyon,4,8,Grand Canyon,-4
2021-03-26,@Seattle,2,1,New Mexico State,1
2021-03-27,@Seattle,1,2,New Mexico State,-1
2021-03-27,@Seattle,4,3,New Mexico State,1
2021-03-29,@Seattle,6,1,New Mexico State,5
2021-04-02,@Seattle,8,6,Pacific Lutheran,2
2021-04-09,@Seattle,2,4,Tarleton State,-2
2021-04-10,@Seattle,5,6,Tarleton State,-1
2021-04-10,@Seattle,3,2,Tarleton State,1
2021-04-11,@Seattle,0,3,Tarleton State,-3
2021-04-16,@Sacramento State,6,0,Sacramento State,6
2021-04-17,@Sacramento State,5,0,Sacramento State,5
2021-04-17,@Sacramento State,3,0,Sacramento State,3
2021-04-18,@Sacramento State,4,11,Sacramento State,-7
2021-04-23,@Texas-Rio Grande Valley,4,11,Texas-Rio Grande Valley,-7
2021-04-24,@Texas-Rio Grande Valley,0,13,Texas-Rio Grande Valley,-13
2021-04-24,@Texas-Rio Grande Valley,4,5,Texas-Rio Grande Valley,-1
2021-04-25,@Texas-Rio Grande Valley,5,6,Texas-Rio Grande Valley,-1
2021-04-30,@Seattle,1,9,California Baptist,-8
2021-05-01,@Seattle,4,7,California Baptist,-3
2021-05-01,@Seattle,1,6,California Baptist,-5
2021-05-02,@Seattle,1,9,California Baptist,-8
2021-05-05,@Washington State,8,16,Washington State,-8
2021-05-14,@Dixie State,3,6,Dixie State,-3
2021-05-15,@Dixie State,13,14,Dixie State,-1
2021-05-15,@Dixie State,7,9,Dixie State,-2
2021-05-16,@Dixie State,4,14,Dixie State,-10
2021-05-20,@Seattle,7,2,Utah Valley,5
2021-05-21,@Seattle,7,2,Utah Valley,5
2021-05-21,@Seattle,5,3,Utah Valley,2
2021-05-22,@Seattle,5,14,Utah Valley,-9
2021-05-26,@New Mexico State,5,7,New Mexico State,-2
2021-05-27,@Seattle,9,8,Utah Valley,1
2021-05-28,@New Mexico State,10,0,New Mexico State,10
2021-05-28,@Seattle,9,19,Texas-Rio Grande Valley,-10
2021-02-21,@Seton Hall,3,2,Hofstra,1
2021-02-21,@Seton Hall,2,3,Hofstra,-1
2021-02-26,@Florida Atlantic,2,6,Florida Atlantic,-4
2021-02-27,@Florida Atlantic,14,17,Florida Atlantic,-3
2021-02-28,@Florida Atlantic,4,10,Florida Atlantic,-6
2021-03-06,@Seton Hall,3,4,Albany,-1
2021-03-06,@Seton Hall,12,0,Albany,12
2021-03-12,@Kent State,7,10,Kent State,-3
2021-03-13,@Kent State,4,12,Kent State,-8
2021-03-14,@Kent State,7,4,Kent State,3
2021-03-19,@George Washington,8,13,George Washington,-5
2021-03-20,@George Washington,8,0,George Washington,8
2021-03-21,@George Washington,8,4,George Washington,4
2021-03-26,@Davidson,5,6,Davidson,-1
2021-03-27,@Davidson,1,2,Davidson,-1
2021-03-28,@Davidson,2,3,Davidson,-1
2021-03-31,@Fordham,4,3,Fordham,1
2021-04-01,@Seton Hall,11,4,Fordham,7
2021-04-03,@Seton Hall,0,1,Fordham,-1
2021-04-09,@Seton Hall,3,2,Butler,1
2021-04-09,@Seton Hall,7,5,Butler,2
2021-04-10,@Seton Hall,4,7,Butler,-3
2021-04-10,@Seton Hall,7,4,Butler,3
2021-04-16,@Villanova,1,0,Villanova,1
2021-04-17,@Villanova,13,2,Villanova,11
2021-04-18,@Villanova,4,1,Villanova,3
2021-04-23,@St. John's,4,5,St. John's,-1
2021-04-24,@St. John's,19,4,St. John's,15
2021-04-24,@St. John's,11,1,St. John's,10
2021-04-25,@St. John's,2,4,St. John's,-2
2021-04-30,@Seton Hall,8,7,Georgetown,1
2021-05-01,@Seton Hall,8,4,Georgetown,4
2021-05-01,@Seton Hall,2,0,Georgetown,2
2021-05-02,@Seton Hall,2,0,Georgetown,2
2021-05-07,@Xavier,4,1,Xavier,3
2021-05-07,@Xavier,1,6,Xavier,-5
2021-05-08,@Xavier,7,2,Xavier,5
2021-05-08,@Xavier,6,7,Xavier,-1
2021-05-14,@Seton Hall,1,6,Creighton,-5
2021-05-15,@Seton Hall,5,3,Creighton,2
2021-05-15,@Seton Hall,15,0,Creighton,15
2021-05-16,@Seton Hall,1,3,Creighton,-2
2021-05-20,@Connecticut,4,11,Connecticut,-7
2021-05-21,@Connecticut,4,12,Connecticut,-8
2021-05-21,@Connecticut,1,15,Connecticut,-14
2021-05-22,@Connecticut,2,10,Connecticut,-8
2021-05-27,@Creighton,7,8,Creighton,-1
2021-05-28,@Seton Hall,2,4,Xavier,-2
2021-03-21,@Siena,15,5,Iona,10
2021-03-21,@Siena,4,3,Iona,1
2021-03-22,@Siena,10,16,Iona,-6
2021-03-22,@Siena,7,10,Iona,-3
2021-03-26,@Siena,11,4,Niagara,7
2021-03-26,@Siena,0,2,Niagara,-2
2021-03-27,@Siena,9,10,Niagara,-1
2021-03-27,@Siena,1,3,Niagara,-2
2021-04-02,@Monmouth,0,5,Monmouth,-5
2021-04-02,@Monmouth,0,6,Monmouth,-6
2021-04-03,@Monmouth,0,2,Monmouth,-2
2021-04-03,@Monmouth,1,13,Monmouth,-12
2021-04-09,@Quinnipiac,10,6,Quinnipiac,4
2021-04-09,@Quinnipiac,1,11,Quinnipiac,-10
2021-04-10,@Quinnipiac,5,9,Quinnipiac,-4
2021-04-10,@Quinnipiac,8,6,Quinnipiac,2
2021-04-17,@Siena,0,11,Manhattan,-11
2021-04-17,@Siena,12,4,Manhattan,8
2021-04-18,@Siena,4,7,Manhattan,-3
2021-04-18,@Siena,11,13,Manhattan,-2
2021-04-20,@Marist,3,16,Marist,-13
2021-04-20,@Marist,1,16,Marist,-15
2021-04-23,@Siena,10,0,St. Peter's,10
2021-04-23,@Siena,8,1,St. Peter's,7
2021-04-24,@Siena,14,1,St. Peter's,13
2021-04-24,@Siena,7,0,St. Peter's,7
2021-05-01,@Fairfield,0,10,Fairfield,-10
2021-05-01,@Fairfield,1,2,Fairfield,-1
2021-05-02,@Fairfield,6,1,Fairfield,5
2021-05-02,@Fairfield,0,4,Fairfield,-4
2021-05-08,@Siena,3,0,Rider,3
2021-05-08,@Siena,0,1,Rider,-1
2021-05-09,@Siena,9,3,Rider,6
2021-05-09,@Siena,4,0,Rider,4
2021-05-12,@Marist,2,10,Marist,-8
2021-05-12,@Marist,6,13,Marist,-7
2021-05-21,@Monmouth,13,5,Monmouth,8
2021-05-21,@Monmouth,2,14,Monmouth,-12
2021-05-22,@Monmouth,4,6,Monmouth,-2
2021-02-19,@South Alabama,2,4,Southeast Missouri State,-2
2021-02-20,@South Alabama,6,5,Southeast Missouri State,1
2021-02-21,@South Alabama,6,8,Southeast Missouri State,-2
2021-02-23,@South Alabama,5,3,Southern Mississippi,2
2021-02-26,@Oral Roberts,7,1,Oral Roberts,6
2021-02-27,@Oral Roberts,4,3,Oral Roberts,1
2021-02-27,@Oral Roberts,2,9,Oral Roberts,-7
2021-03-03,@New Orleans,5,0,New Orleans,5
2021-03-05,@South Alabama,5,4,Middle Tennessee State,1
2021-03-06,@South Alabama,2,8,Middle Tennessee State,-6
2021-03-07,@South Alabama,2,4,Middle Tennessee State,-2
2021-03-09,@Alabama,8,11,Alabama,-3
2021-03-12,@South Alabama,2,11,Jacksonville State,-9
2021-03-13,@South Alabama,2,8,Jacksonville State,-6
2021-03-14,@South Alabama,7,5,Jacksonville State,2
2021-03-16,@South Alabama,8,2,Southern Mississippi,6
2021-03-19,@Texas-Arlington,2,3,Texas-Arlington,-1
2021-03-20,@Texas-Arlington,6,4,Texas-Arlington,2
2021-03-21,@Texas-Arlington,6,3,Texas-Arlington,3
2021-03-26,@Northwestern State,8,6,Northwestern State,2
2021-03-27,@Northwestern State,6,5,Northwestern State,1
2021-03-28,@Northwestern State,12,1,Northwestern State,11
2021-03-30,@Louisiana State,1,11,Louisiana State,-10
2021-04-01,@South Alabama,6,0,Troy,6
2021-04-02,@South Alabama,6,3,Troy,3
2021-04-03,@South Alabama,8,0,Troy,8
2021-04-09,@Arkansas-Little Rock,3,7,Arkansas-Little Rock,-4
2021-04-10,@Arkansas-Little Rock,2,4,Arkansas-Little Rock,-2
2021-04-11,@Arkansas-Little Rock,8,9,Arkansas-Little Rock,-1
2021-04-13,@Southern Mississippi,4,0,Southern Mississippi,4
2021-04-18,@South Alabama,4,1,Louisiana-Lafayette,3
2021-04-19,@South Alabama,3,2,Louisiana-Lafayette,1
2021-04-19,@South Alabama,8,2,Louisiana-Lafayette,6
2021-04-21,@South Alabama,5,0,Southern,5
2021-04-23,@South Alabama,4,2,Georgia State,2
2021-04-25,@South Alabama,5,1,Georgia State,4
2021-04-25,@South Alabama,4,2,Georgia State,2
2021-04-30,@Georgia Southern,12,5,Georgia Southern,7
2021-05-01,@Georgia Southern,2,11,Georgia Southern,-9
2021-05-02,@Georgia Southern,6,7,Georgia Southern,-1
2021-05-07,@Texas State,3,6,Texas State,-3
2021-05-08,@Texas State,4,13,Texas State,-9
2021-05-09,@Texas State,9,4,Texas State,5
2021-05-14,@South Alabama,2,4,Coastal Carolina,-2
2021-05-15,@South Alabama,3,1,Coastal Carolina,2
2021-05-16,@South Alabama,4,1,Coastal Carolina,3
2021-05-20,@Appalachian State,4,6,Appalachian State,-2
2021-05-21,@Appalachian State,2,4,Appalachian State,-2
2021-05-22,@Appalachian State,13,3,Appalachian State,10
2021-05-26,@South Alabama,14,7,Coastal Carolina,7
2021-05-27,@Arkansas-Little Rock,6,2,Arkansas-Little Rock,4
2021-05-29,@South Alabama,5,4,Texas-Arlington,1
2021-05-30,@South Alabama,10,4,Georgia Southern,6
2021-06-04,"@Miami, Florida",0,1,"Miami, Florida",-1
2021-06-05,@South Alabama,19,1,Florida,18
2021-06-06,@South Alabama,7,2,"Miami, Florida",5
2021-06-07,@South Florida,4,0,South Florida,4
2021-06-07,@South Alabama,4,6,South Florida,-2
2021-02-19,@South Carolina,12,1,Dayton,11
2021-02-20,@South Carolina,12,5,Dayton,7
2021-02-21,@South Carolina,5,1,Dayton,4
2021-02-23,@South Carolina,12,4,Winthrop,8
2021-02-27,@South Carolina,3,2,Clemson,1
2021-02-28,@South Carolina,8,7,Clemson,1
2021-03-02,@Winthrop,19,8,Winthrop,11
2021-03-05,@South Carolina,5,1,Mercer,4
2021-03-06,@South Carolina,4,0,Mercer,4
2021-03-07,@South Carolina,1,0,Mercer,1
2021-03-10,@The Citadel,11,7,The Citadel,4
2021-03-12,@Texas,1,4,Texas,-3
2021-03-13,@Texas,0,3,Texas,-3
2021-03-14,@Texas,5,8,Texas,-3
2021-03-17,@South Carolina,4,9,Davidson,-5
2021-03-19,@Vanderbilt,2,3,Vanderbilt,-1
2021-03-20,@Vanderbilt,0,5,Vanderbilt,-5
2021-03-21,@Vanderbilt,6,5,Vanderbilt,1
2021-03-23,@South Carolina,8,3,The Citadel,5
2021-03-26,@South Carolina,9,8,Florida,1
2021-03-27,@South Carolina,4,1,Florida,3
2021-03-28,@South Carolina,8,5,Florida,3
2021-03-30,@South Carolina,9,4,Gardner-Webb,5
2021-04-02,@Georgia,3,5,Georgia,-2
2021-04-03,@Georgia,13,7,Georgia,6
2021-04-04,@Georgia,5,1,Georgia,4
2021-04-06,@South Carolina,2,3,North Carolina,-1
2021-04-09,@South Carolina,2,7,Missouri,-5
2021-04-10,@South Carolina,11,1,Missouri,10
2021-04-11,@South Carolina,13,4,Missouri,9
2021-04-13,@South Carolina,9,0,Charleston Southern,9
2021-04-15,@Louisiana State,1,5,Louisiana State,-4
2021-04-17,@Louisiana State,4,2,Louisiana State,2
2021-04-17,@Louisiana State,9,0,Louisiana State,9
2021-04-22,@South Carolina,1,6,Arkansas,-5
2021-04-23,@South Carolina,6,2,Arkansas,4
2021-04-23,@South Carolina,1,5,Arkansas,-4
2021-04-27,@South Carolina,9,5,The Citadel,4
2021-04-30,@Mississippi,1,5,Mississippi,-4
2021-05-01,@Mississippi,3,7,Mississippi,-4
2021-05-01,@Mississippi,4,6,Mississippi,-2
2021-05-05,@South Carolina,7,6,North Florida,1
2021-05-07,@South Carolina,0,9,Mississippi State,-9
2021-05-08,@South Carolina,6,9,Mississippi State,-3
2021-05-09,@South Carolina,4,3,Mississippi State,1
2021-05-11,@Clemson,2,7,Clemson,-5
2021-05-14,@Kentucky,12,6,Kentucky,6
2021-05-15,@Kentucky,9,0,Kentucky,9
2021-05-16,@Kentucky,11,6,Kentucky,5
2021-05-18,@South Carolina,2,0,Appalachian State,2
2021-05-20,@South Carolina,4,10,Tennessee,-6
2021-05-21,@South Carolina,3,2,Tennessee,1
2021-05-22,@South Carolina,4,5,Tennessee,-1
2021-05-25,@South Carolina,3,9,Alabama,-6
2021-06-04,@South Carolina,4,3,Virginia,1
2021-06-05,@South Carolina,1,2,Old Dominion,-1
2021-06-06,@Virginia,2,3,Virginia,-1
2021-02-19,@South Carolina-Upstate,14,2,Toledo,12
2021-02-20,@South Carolina-Upstate,5,1,Toledo,4
2021-02-21,@South Carolina-Upstate,7,6,Toledo,1
2021-02-26,@College of Charleston,10,3,College of Charleston,7
2021-02-27,@College of Charleston,1,0,College of Charleston,1
2021-02-28,@College of Charleston,13,10,College of Charleston,3
2021-03-05,@South Carolina-Upstate,7,6,Radford,1
2021-03-06,@South Carolina-Upstate,6,1,Radford,5
2021-03-06,@South Carolina-Upstate,7,0,Radford,7
2021-03-09,@Clemson,12,2,Clemson,10
2021-03-12,@Campbell,6,1,Campbell,5
2021-03-13,@Campbell,3,4,Campbell,-1
2021-03-13,@Campbell,2,4,Campbell,-2
2021-03-17,@South Carolina-Upstate,4,1,North Carolina-Asheville,3
2021-03-19,@South Carolina-Upstate,1,3,High Point,-2
2021-03-20,@South Carolina-Upstate,8,1,High Point,7
2021-03-20,@South Carolina-Upstate,7,2,High Point,5
2021-03-23,@South Carolina-Upstate,13,0,Presbyterian,13
2021-03-26,@Winthrop,5,0,Winthrop,5
2021-03-27,@Winthrop,1,2,Winthrop,-1
2021-03-27,@Winthrop,2,5,Winthrop,-3
2021-04-02,@Radford,3,2,Radford,1
2021-04-03,@Radford,2,5,Radford,-3
2021-04-03,@Radford,5,4,Radford,1
2021-04-06,@Georgia Tech,9,3,Georgia Tech,6
2021-04-09,@South Carolina-Upstate,5,8,Gardner-Webb,-3
2021-04-11,@South Carolina-Upstate,9,8,Gardner-Webb,1
2021-04-11,@South Carolina-Upstate,13,2,Gardner-Webb,11
2021-04-13,@Wofford,9,7,Wofford,2
2021-04-16,@Charleston Southern,2,0,Charleston Southern,2
2021-04-17,@Charleston Southern,0,6,Charleston Southern,-6
2021-04-17,@Charleston Southern,4,5,Charleston Southern,-1
2021-04-20,@Presbyterian,11,8,Presbyterian,3
2021-04-23,@South Carolina-Upstate,10,3,Longwood,7
2021-04-23,@South Carolina-Upstate,13,5,Longwood,8
2021-04-25,@South Carolina-Upstate,13,3,Longwood,10
2021-04-30,@South Carolina-Upstate,8,1,Presbyterian,7
2021-05-01,@South Carolina-Upstate,8,4,Presbyterian,4
2021-05-01,@South Carolina-Upstate,12,11,Presbyterian,1
2021-05-05,@Clemson,2,9,Clemson,-7
2021-05-07,@High Point,10,6,High Point,4
2021-05-08,@High Point,12,9,High Point,3
2021-05-08,@High Point,10,5,High Point,5
2021-05-11,@North Carolina-Asheville,7,6,North Carolina-Asheville,1
2021-05-14,@South Carolina-Upstate,5,6,Campbell,-1
2021-05-15,@South Carolina-Upstate,0,8,Campbell,-8
2021-05-15,@South Carolina-Upstate,0,12,Campbell,-12
2021-05-18,@Louisville,6,8,Louisville,-2
2021-05-20,@North Carolina-Asheville,14,4,North Carolina-Asheville,10
2021-05-21,@North Carolina-Asheville,7,4,North Carolina-Asheville,3
2021-05-21,@North Carolina-Asheville,4,3,North Carolina-Asheville,1
2021-05-27,@South Carolina-Upstate,4,11,Gardner-Webb,-7
2021-05-28,@Campbell,3,5,Campbell,-2
2021-02-19,@Kansas,3,7,Kansas,-4
2021-02-20,@Kansas,8,5,Kansas,3
2021-02-21,@Kansas,1,13,Kansas,-12
2021-02-26,@Northern Colorado,12,0,Northern Colorado,12
2021-02-27,@Northern Colorado,6,2,Northern Colorado,4
2021-02-28,@Northern Colorado,12,9,Northern Colorado,3
2021-02-28,@Northern Colorado,6,3,Northern Colorado,3
2021-03-05,@Southern Illinois-Edwardsville,3,11,Southern Illinois-Edwardsville,-8
2021-03-06,@Southern Illinois-Edwardsville,1,6,Southern Illinois-Edwardsville,-5
2021-03-07,@Southern Illinois-Edwardsville,3,4,Southern Illinois-Edwardsville,-1
2021-03-09,@Kansas State,4,15,Kansas State,-11
2021-03-10,@Kansas State,0,10,Kansas State,-10
2021-03-19,@Nebraska-Omaha,1,6,Nebraska-Omaha,-5
2021-03-19,@Nebraska-Omaha,1,7,Nebraska-Omaha,-6
2021-03-20,@Nebraska-Omaha,7,6,Nebraska-Omaha,1
2021-03-21,@Nebraska-Omaha,1,7,Nebraska-Omaha,-6
2021-03-26,@Western Illinois,0,5,Western Illinois,-5
2021-03-26,@Western Illinois,10,3,Western Illinois,7
2021-03-27,@Western Illinois,3,4,Western Illinois,-1
2021-03-28,@Western Illinois,5,6,Western Illinois,-1
2021-04-02,@Evansville,3,13,Evansville,-10
2021-04-03,@Evansville,2,3,Evansville,-1
2021-04-03,@Evansville,1,11,Evansville,-10
2021-04-04,@Evansville,8,14,Evansville,-6
2021-04-10,@South Dakota State,5,10,Nebraska-Omaha,-5
2021-04-10,@South Dakota State,1,2,Nebraska-Omaha,-1
2021-04-11,@South Dakota State,9,8,Nebraska-Omaha,1
2021-04-11,@South Dakota State,6,0,Nebraska-Omaha,6
2021-04-23,@South Dakota State,0,5,North Dakota State,-5
2021-04-23,@South Dakota State,3,2,North Dakota State,1
2021-04-24,@South Dakota State,12,2,North Dakota State,10
2021-04-24,@South Dakota State,12,13,North Dakota State,-1
2021-04-30,@Oral Roberts,4,14,Oral Roberts,-10
2021-05-01,@Oral Roberts,2,6,Oral Roberts,-4
2021-05-01,@Oral Roberts,0,1,Oral Roberts,-1
2021-05-02,@Oral Roberts,0,9,Oral Roberts,-9
2021-05-14,@North Dakota State,5,0,North Dakota State,5
2021-05-14,@North Dakota State,4,7,North Dakota State,-3
2021-05-15,@North Dakota State,3,5,North Dakota State,-2
2021-05-16,@North Dakota State,4,10,North Dakota State,-6
2021-05-20,@South Dakota State,3,4,Oral Roberts,-1
2021-05-20,@South Dakota State,8,11,Oral Roberts,-3
2021-05-21,@South Dakota State,4,3,Oral Roberts,1
2021-05-22,@South Dakota State,7,4,Oral Roberts,3
2021-05-27,@Oral Roberts,1,7,Oral Roberts,-6
2021-05-28,@Nebraska-Omaha,7,0,Nebraska-Omaha,7
2021-05-28,@South Dakota State,3,5,Oral Roberts,-2
2021-02-20,@South Florida,1,4,Florida Gulf Coast,-3
2021-02-20,@South Florida,6,11,Florida Gulf Coast,-5
2021-02-21,@Florida Gulf Coast,10,12,Florida Gulf Coast,-2
2021-02-26,@South Florida,13,0,Florida A&M,13
2021-02-26,@South Florida,3,1,Florida A&M,2
2021-02-27,@South Florida,9,4,Florida A&M,5
2021-02-28,@South Florida,9,8,Florida A&M,1
2021-03-05,@Stetson,3,2,Stetson,1
2021-03-06,@Stetson,10,5,Stetson,5
2021-03-07,@South Florida,6,5,Stetson,1
2021-03-12,@Florida Gulf Coast,1,7,Florida Gulf Coast,-6
2021-03-13,@South Florida,5,6,Florida Gulf Coast,-1
2021-03-14,@Florida Gulf Coast,13,17,Florida Gulf Coast,-4
2021-03-16,@South Florida,12,14,Stetson,-2
2021-03-19,@South Florida,1,5,Florida Atlantic,-4
2021-03-20,@South Florida,4,0,Florida Atlantic,4
2021-03-21,@South Florida,6,5,Florida Atlantic,1
2021-03-23,@South Florida,2,3,North Florida,-1
2021-03-26,@Texas Tech,6,16,Texas Tech,-10
2021-03-27,@Texas Tech,0,8,Texas Tech,-8
2021-03-28,@Texas Tech,4,7,Texas Tech,-3
2021-03-30,@South Florida,7,3,Stetson,4
2021-04-01,@South Florida,2,5,Central Florida,-3
2021-04-02,@South Florida,6,2,Central Florida,4
2021-04-02,@South Florida,3,1,Central Florida,2
2021-04-03,@South Florida,0,3,Central Florida,-3
2021-04-16,@Central Florida,0,6,Central Florida,-6
2021-04-16,@Central Florida,2,5,Central Florida,-3
2021-04-17,@Central Florida,4,5,Central Florida,-1
2021-04-17,@Central Florida,11,0,Central Florida,11
2021-04-24,@Houston,8,4,Houston,4
2021-04-24,@Houston,2,9,Houston,-7
2021-04-25,@Houston,2,5,Houston,-3
2021-04-25,@Houston,4,0,Houston,4
2021-04-30,@South Florida,4,2,Cincinnati,2
2021-04-30,@South Florida,3,5,Cincinnati,-2
2021-05-01,@South Florida,12,3,Cincinnati,9
2021-05-02,@South Florida,4,6,Cincinnati,-2
2021-05-07,@Memphis,9,2,Memphis,7
2021-05-07,@Memphis,1,3,Memphis,-2
2021-05-08,@Memphis,7,4,Memphis,3
2021-05-08,@Memphis,6,5,Memphis,1
2021-05-14,@Wichita State,3,9,Wichita State,-6
2021-05-14,@Wichita State,8,2,Wichita State,6
2021-05-15,@Wichita State,7,1,Wichita State,6
2021-05-16,@Wichita State,4,6,Wichita State,-2
2021-05-20,@South Florida,2,5,East Carolina,-3
2021-05-20,@South Florida,1,10,East Carolina,-9
2021-05-21,@South Florida,7,0,East Carolina,7
2021-05-22,@South Florida,8,2,East Carolina,6
2021-05-25,@Wichita State,7,2,Wichita State,5
2021-05-27,@Tulane,5,0,Tulane,5
2021-05-29,@Tulane,6,16,Tulane,-10
2021-05-29,@Tulane,7,1,Tulane,6
2021-05-30,@Central Florida,8,7,Central Florida,1
2021-06-04,@Florida,5,3,Florida,2
2021-06-05,@South Florida,10,2,"Miami, Florida",8
2021-06-07,@South Florida,0,4,South Alabama,-4
2021-06-07,@South Alabama,6,4,South Alabama,2
2021-06-12,@Texas,3,4,Texas,-1
2021-06-13,@South Florida,4,12,Texas,-8
2021-02-19,@South Alabama,4,2,South Alabama,2
2021-02-20,@South Alabama,5,6,South Alabama,-1
2021-02-21,@South Alabama,8,6,South Alabama,2
2021-02-25,@Arkansas,5,6,Arkansas,-1
2021-02-26,@Arkansas,3,7,Arkansas,-4
2021-02-27,@Arkansas,3,9,Arkansas,-6
2021-02-28,@Arkansas,4,11,Arkansas,-7
2021-03-05,@Southeast Missouri State,4,3,Illinois State,1
2021-03-06,@Southeast Missouri State,5,1,Illinois State,4
2021-03-06,@Southeast Missouri State,1,13,Illinois State,-12
2021-03-07,@Southeast Missouri State,8,1,Illinois State,7
2021-03-12,@Southern Illinois-Edwardsville,2,6,Southern Illinois-Edwardsville,-4
2021-03-13,@Southern Illinois-Edwardsville,6,4,Southern Illinois-Edwardsville,2
2021-03-13,@Southern Illinois-Edwardsville,6,3,Southern Illinois-Edwardsville,3
2021-03-16,@St. Louis,8,6,St. Louis,2
2021-03-19,@Southeast Missouri State,6,3,Austin Peay State,3
2021-03-20,@Southeast Missouri State,6,5,Austin Peay State,1
2021-03-20,@Southeast Missouri State,11,12,Austin Peay State,-1
2021-03-24,@Southeast Missouri State,4,21,Southern Illinois,-17
2021-03-26,@Eastern Illinois,3,2,Eastern Illinois,1
2021-03-27,@Eastern Illinois,2,9,Eastern Illinois,-7
2021-03-27,@Eastern Illinois,4,8,Eastern Illinois,-4
2021-03-30,@Southeast Missouri State,8,9,Missouri State,-1
2021-04-02,@Southeast Missouri State,6,5,Jacksonville State,1
2021-04-03,@Southeast Missouri State,4,8,Jacksonville State,-4
2021-04-03,@Southeast Missouri State,8,3,Jacksonville State,5
2021-04-09,@Murray State,12,8,Murray State,4
2021-04-09,@Murray State,8,3,Murray State,5
2021-04-10,@Murray State,6,11,Murray State,-5
2021-04-13,@Tennessee-Martin,8,1,Tennessee-Martin,7
2021-04-16,@Southeast Missouri State,7,3,Tennessee Tech,4
2021-04-17,@Southeast Missouri State,1,9,Tennessee Tech,-8
2021-04-17,@Southeast Missouri State,7,2,Tennessee Tech,5
2021-04-28,@Austin Peay State,16,3,Austin Peay State,13
2021-04-30,@Belmont,12,0,Belmont,12
2021-05-01,@Belmont,1,4,Belmont,-3
2021-05-01,@Belmont,5,0,Belmont,5
2021-05-07,@Southeast Missouri State,6,2,Eastern Kentucky,4
2021-05-07,@Southeast Missouri State,0,8,Eastern Kentucky,-8
2021-05-08,@Southeast Missouri State,7,6,Eastern Kentucky,1
2021-05-13,@Lipscomb,3,2,Lipscomb,1
2021-05-14,@Lipscomb,0,3,Lipscomb,-3
2021-05-15,@Lipscomb,8,4,Lipscomb,4
2021-05-20,@Southeast Missouri State,6,2,Tennessee-Martin,4
2021-05-21,@Southeast Missouri State,3,2,Tennessee-Martin,1
2021-05-21,@Southeast Missouri State,2,9,Tennessee-Martin,-7
2021-05-27,@Southeast Missouri State,11,8,Austin Peay State,3
2021-05-28,@Southeast Missouri State,6,5,Murray State,1
2021-05-29,@Southeast Missouri State,1,10,Murray State,-9
2021-05-30,@Southeast Missouri State,10,1,Murray State,9
2021-06-04,@Mississippi,3,6,Mississippi,-3
2021-06-05,@Southeast Missouri State,0,21,Southern Mississippi,-21
2021-02-20,@Southeastern Louisiana,23,0,Mississippi Valley State,23
2021-02-20,@Southeastern Louisiana,26,0,Mississippi Valley State,26
2021-02-21,@Southeastern Louisiana,17,0,Mississippi Valley State,17
2021-02-25,@Arizona,4,7,Arizona,-3
2021-02-26,@Arizona,11,13,Arizona,-2
2021-02-27,@Arizona,3,4,Arizona,-1
2021-02-28,@Arizona,2,14,Arizona,-12
2021-03-03,@Southeastern Louisiana,6,1,Tulane,5
2021-03-05,@Southeastern Louisiana,7,2,Troy,5
2021-03-06,@Southeastern Louisiana,7,1,Troy,6
2021-03-07,@Southeastern Louisiana,4,2,Troy,2
2021-03-12,@Southeastern Louisiana,12,3,Sam Houston State,9
2021-03-13,@Southeastern Louisiana,3,2,Sam Houston State,1
2021-03-13,@Southeastern Louisiana,7,6,Sam Houston State,1
2021-03-14,@Southeastern Louisiana,3,1,Sam Houston State,2
2021-03-16,@Louisiana State,7,10,Louisiana State,-3
2021-03-19,@Incarnate Word,5,6,Incarnate Word,-1
2021-03-20,@Incarnate Word,7,6,Incarnate Word,1
2021-03-20,@Incarnate Word,0,5,Incarnate Word,-5
2021-03-21,@Incarnate Word,3,5,Incarnate Word,-2
2021-03-26,@Lamar,3,0,Lamar,3
2021-03-27,@Lamar,6,2,Lamar,4
2021-03-27,@Lamar,6,5,Lamar,1
2021-03-28,@Lamar,9,8,Lamar,1
2021-04-01,@Southeastern Louisiana,4,6,McNeese State,-2
2021-04-02,@Southeastern Louisiana,0,5,McNeese State,-5
2021-04-02,@Southeastern Louisiana,6,3,McNeese State,3
2021-04-03,@Southeastern Louisiana,13,9,McNeese State,4
2021-04-09,@Southeastern Louisiana,9,13,Abilene Christian,-4
2021-04-10,@Southeastern Louisiana,4,8,Abilene Christian,-4
2021-04-10,@Southeastern Louisiana,8,3,Abilene Christian,5
2021-04-11,@Southeastern Louisiana,7,0,Abilene Christian,7
2021-04-17,@Stephen F. Austin State,7,4,Stephen F. Austin State,3
2021-04-17,@Stephen F. Austin State,6,2,Stephen F. Austin State,4
2021-04-18,@Stephen F. Austin State,9,6,Stephen F. Austin State,3
2021-04-18,@Stephen F. Austin State,5,3,Stephen F. Austin State,2
2021-04-23,@New Orleans,8,9,New Orleans,-1
2021-04-24,@New Orleans,4,8,New Orleans,-4
2021-04-24,@New Orleans,3,11,New Orleans,-8
2021-04-25,@New Orleans,7,0,New Orleans,7
2021-05-05,@Southern Mississippi,5,3,Southern Mississippi,2
2021-05-07,@Southeastern Louisiana,3,11,Nicholls State,-8
2021-05-08,@Southeastern Louisiana,7,6,Nicholls State,1
2021-05-08,@Southeastern Louisiana,5,4,Nicholls State,1
2021-05-09,@Nicholls State,2,4,Nicholls State,-2
2021-05-14,@Texas A&M-Corpus Christi,1,2,Texas A&M-Corpus Christi,-1
2021-05-14,@Texas A&M-Corpus Christi,3,4,Texas A&M-Corpus Christi,-1
2021-05-15,@Texas A&M-Corpus Christi,6,10,Texas A&M-Corpus Christi,-4
2021-05-20,@Southeastern Louisiana,10,0,Houston Baptist,10
2021-05-21,@Southeastern Louisiana,1,3,Houston Baptist,-2
2021-05-21,@Southeastern Louisiana,3,4,Houston Baptist,-1
2021-05-22,@Southeastern Louisiana,8,2,Houston Baptist,6
2021-05-26,@Southeastern Louisiana,2,1,Northwestern State,1
2021-05-27,@McNeese State,2,3,McNeese State,-1
2021-05-28,@New Orleans,15,13,New Orleans,2
2021-05-28,@Southeastern Louisiana,2,18,McNeese State,-16
2021-02-20,@New Orleans,5,10,New Orleans,-5
2021-02-21,@New Orleans,4,3,New Orleans,1
2021-02-21,@New Orleans,3,6,New Orleans,-3
2021-02-26,@Louisiana Tech,2,9,Louisiana Tech,-7
2021-02-27,@Louisiana Tech,1,5,Louisiana Tech,-4
2021-02-28,@Louisiana Tech,4,12,Louisiana Tech,-8
2021-03-03,@Louisiana State,1,16,Louisiana State,-15
2021-03-05,@Southern,9,8,Grambling State,1
2021-03-06,@Southern,10,9,Grambling State,1
2021-03-07,@Southern,5,3,Grambling State,2
2021-03-09,@Tulane,0,6,Tulane,-6
2021-03-12,@Prairie View A&M,7,5,Prairie View A&M,2
2021-03-13,@Prairie View A&M,10,12,Prairie View A&M,-2
2021-03-13,@Prairie View A&M,4,12,Prairie View A&M,-8
2021-03-16,@Southern,5,7,Lamar,-2
2021-03-19,@Rice,2,14,Rice,-12
2021-03-20,@Rice,4,13,Rice,-9
2021-03-21,@Rice,6,4,Rice,2
2021-03-26,@Arkansas-Pine Bluff,11,8,Arkansas-Pine Bluff,3
2021-03-27,@Arkansas-Pine Bluff,15,8,Arkansas-Pine Bluff,7
2021-03-28,@Arkansas-Pine Bluff,7,5,Arkansas-Pine Bluff,2
2021-04-01,@Texas Southern,2,7,Texas Southern,-5
2021-04-02,@Texas Southern,5,3,Texas Southern,2
2021-04-03,@Texas Southern,6,8,Texas Southern,-2
2021-04-06,@Mississippi State,1,15,Mississippi State,-14
2021-04-10,@Grambling State,9,12,Grambling State,-3
2021-04-10,@Grambling State,6,14,Grambling State,-8
2021-04-11,@Grambling State,10,3,Grambling State,7
2021-04-18,@Southern,1,5,Prairie View A&M,-4
2021-04-19,@Southern,4,6,Prairie View A&M,-2
2021-04-19,@Southern,0,4,Prairie View A&M,-4
2021-04-21,@South Alabama,0,5,South Alabama,-5
2021-04-23,@Louisiana-Monroe,1,12,Louisiana-Monroe,-11
2021-04-25,@Louisiana-Monroe,0,2,Louisiana-Monroe,-2
2021-04-25,@Louisiana-Monroe,1,11,Louisiana-Monroe,-10
2021-04-30,@Southern,8,3,Arkansas-Pine Bluff,5
2021-05-01,@Southern,11,5,Arkansas-Pine Bluff,6
2021-05-01,@Southern,3,6,Arkansas-Pine Bluff,-3
2021-05-03,@Louisiana State,2,10,Louisiana State,-8
2021-05-07,@Southern,7,5,Texas Southern,2
2021-05-08,@Southern,10,14,Texas Southern,-4
2021-05-09,@Southern,12,9,Texas Southern,3
2021-05-19,@Alabama State,3,0,Alabama State,3
2021-05-20,@Prairie View A&M,1,2,Prairie View A&M,-1
2021-05-21,@Prairie View A&M,24,3,Prairie View A&M,21
2021-05-21,@Southern,10,5,Alcorn State,5
2021-05-22,@Prairie View A&M,8,4,Prairie View A&M,4
2021-05-23,@Jackson State,7,6,Jackson State,1
2021-06-04,@Texas,0,11,Texas,-11
2021-06-05,@Fairfield,2,6,Fairfield,-4
2021-02-19,@Southern California,3,2,Loyola Marymount,1
2021-02-20,@Southern California,5,0,Loyola Marymount,5
2021-02-21,@Loyola Marymount,8,9,Loyola Marymount,-1
2021-02-26,@Southern California,1,2,Cal Poly,-1
2021-02-27,@Southern California,4,9,Cal Poly,-5
2021-02-28,@Southern California,7,6,Cal Poly,1
2021-03-05,@Southern California,0,5,Cal State Fullerton,-5
2021-03-06,@Southern California,5,11,Pepperdine,-6
2021-03-07,@UCLA,1,10,UCLA,-9
2021-03-12,@Southern California,3,1,Nevada,2
2021-03-13,@Southern California,5,4,Nevada,1
2021-03-14,@Southern California,7,2,Nevada,5
2021-03-19,@Washington,3,2,Washington,1
2021-03-20,@Washington,7,5,Washington,2
2021-03-21,@Washington,11,3,Washington,8
2021-03-23,@Southern California,5,6,San Diego,-1
2021-03-26,@Southern California,5,4,UCLA,1
2021-03-27,@Southern California,3,6,UCLA,-3
2021-03-28,@Southern California,1,13,UCLA,-12
2021-03-30,@Loyola Marymount,4,3,Loyola Marymount,1
2021-04-01,@California,6,1,California,5
2021-04-02,@California,3,4,California,-1
2021-04-03,@California,1,5,California,-4
2021-04-09,@Southern California,14,1,Dixie State,13
2021-04-10,@Southern California,10,3,Dixie State,7
2021-04-11,@Southern California,6,5,Dixie State,1
2021-04-13,@Southern California,2,1,Fresno State,1
2021-04-16,@Southern California,9,5,Oregon,4
2021-04-17,@Southern California,4,13,Oregon,-9
2021-04-18,@Southern California,5,7,Oregon,-2
2021-04-20,@Southern California,8,1,Loyola Marymount,7
2021-04-23,@Arizona,5,8,Arizona,-3
2021-04-24,@Arizona,6,10,Arizona,-4
2021-04-25,@Arizona,4,8,Arizona,-4
2021-04-27,@Southern California,2,5,Pepperdine,-3
2021-04-30,@Southern California,2,5,Stanford,-3
2021-05-01,@Southern California,2,3,Stanford,-1
2021-05-02,@Southern California,2,1,Stanford,1
2021-05-07,@Oregon State,4,5,Oregon State,-1
2021-05-08,@Oregon State,7,9,Oregon State,-2
2021-05-09,@Oregon State,5,3,Oregon State,2
2021-05-14,@Southern California,8,6,Washington State,2
2021-05-15,@Southern California,3,2,Washington State,1
2021-05-16,@Southern California,2,13,Washington State,-11
2021-05-18,@Fresno State,10,13,Fresno State,-3
2021-05-21,@Southern California,2,6,Arizona State,-4
2021-05-22,@Southern California,6,1,Arizona State,5
2021-05-23,@Southern California,7,10,Arizona State,-3
2021-05-27,@Utah,7,3,Utah,4
2021-05-28,@Utah,1,2,Utah,-1
2021-05-29,@Utah,17,11,Utah,6
2021-02-19,@Jacksonville State,8,7,Jacksonville State,1
2021-02-20,@Southern Illinois,4,3,Tennessee Tech,1
2021-02-21,@Alabama State,13,1,Alabama State,12
2021-02-23,@Southern Illinois,10,9,Eastern Illinois,1
2021-02-26,@Mercer,17,7,Mercer,10
2021-02-27,@Mercer,11,5,Mercer,6
2021-02-28,@Mercer,5,2,Mercer,3
2021-03-02,@Southern Illinois,9,1,Western Illinois,8
2021-03-05,@Southern Illinois,14,7,Tennessee-Martin,7
2021-03-06,@Southern Illinois,8,4,Tennessee-Martin,4
2021-03-07,@Southern Illinois,8,3,Tennessee-Martin,5
2021-03-12,@Southern Illinois,14,5,Evansville,9
2021-03-13,@Southern Illinois,5,3,Evansville,2
2021-03-13,@Southern Illinois,9,4,Evansville,5
2021-03-14,@Southern Illinois,3,7,Evansville,-4
2021-03-19,@Southern Illinois,10,4,Marshall,6
2021-03-20,@Southern Illinois,7,2,Marshall,5
2021-03-21,@Southern Illinois,2,0,Marshall,2
2021-03-24,@Southeast Missouri State,21,4,Southeast Missouri State,17
2021-03-26,@Southern Illinois,10,7,Arkansas-Little Rock,3
2021-03-27,@Southern Illinois,5,11,Arkansas-Little Rock,-6
2021-03-28,@Southern Illinois,5,11,Arkansas-Little Rock,-6
2021-04-02,@Southern Illinois,3,11,Illinois State,-8
2021-04-03,@Southern Illinois,3,6,Illinois State,-3
2021-04-03,@Southern Illinois,8,4,Illinois State,4
2021-04-04,@Southern Illinois,11,14,Illinois State,-3
2021-04-06,@Southern Illinois,15,0,Austin Peay State,15
2021-04-10,@Southern Illinois,14,6,Bellarmine,8
2021-04-10,@Southern Illinois,13,12,Northern Illinois,1
2021-04-11,@Southern Illinois,8,4,Northern Illinois,4
2021-04-16,@Bradley,5,4,Bradley,1
2021-04-17,@Bradley,2,3,Bradley,-1
2021-04-17,@Bradley,1,2,Bradley,-1
2021-04-18,@Bradley,0,6,Bradley,-6
2021-04-23,@Valparaiso,6,7,Valparaiso,-1
2021-04-23,@Valparaiso,3,4,Valparaiso,-1
2021-04-24,@Valparaiso,10,4,Valparaiso,6
2021-04-25,@Valparaiso,2,4,Valparaiso,-2
2021-04-27,@Southern Illinois,5,4,Murray State,1
2021-04-30,@Southern Illinois,3,2,Missouri State,1
2021-05-01,@Southern Illinois,6,5,Missouri State,1
2021-05-01,@Southern Illinois,4,0,Missouri State,4
2021-05-02,@Southern Illinois,5,0,Missouri State,5
2021-05-07,@Evansville,16,7,Evansville,9
2021-05-07,@Evansville,6,8,Evansville,-2
2021-05-08,@Evansville,5,0,Evansville,5
2021-05-09,@Evansville,5,6,Evansville,-1
2021-05-11,@Murray State,4,5,Murray State,-1
2021-05-14,@Indiana State,4,5,Indiana State,-1
2021-05-15,@Indiana State,8,7,Indiana State,1
2021-05-15,@Indiana State,11,4,Indiana State,7
2021-05-16,@Indiana State,5,0,Indiana State,5
2021-05-20,@Southern Illinois,0,19,Dallas Baptist,-19
2021-05-21,@Southern Illinois,9,8,Dallas Baptist,1
2021-05-21,@Southern Illinois,0,3,Dallas Baptist,-3
2021-05-22,@Southern Illinois,5,3,Dallas Baptist,2
2021-05-26,@Bradley,13,1,Bradley,12
2021-05-28,@Southern Illinois,8,11,Indiana State,-3
2021-05-28,@Valparaiso,11,5,Valparaiso,6
2021-05-29,@Southern Illinois,7,9,Indiana State,-2
2021-02-23,@Southern Illinois-Edwardsville,1,9,Illinois State,-8
2021-02-23,@Southern Illinois-Edwardsville,1,6,Illinois State,-5
2021-02-26,@Wichita State,4,10,Wichita State,-6
2021-02-27,@Wichita State,9,7,Wichita State,2
2021-02-28,@Wichita State,5,7,Wichita State,-2
2021-03-02,@Southern Illinois-Edwardsville,11,1,St. Louis,10
2021-03-05,@Southern Illinois-Edwardsville,11,3,South Dakota State,8
2021-03-06,@Southern Illinois-Edwardsville,6,1,South Dakota State,5
2021-03-07,@Southern Illinois-Edwardsville,4,3,South Dakota State,1
2021-03-12,@Southern Illinois-Edwardsville,6,2,Southeast Missouri State,4
2021-03-13,@Southern Illinois-Edwardsville,4,6,Southeast Missouri State,-2
2021-03-13,@Southern Illinois-Edwardsville,3,6,Southeast Missouri State,-3
2021-03-16,@Southern Illinois-Edwardsville,5,6,Western Illinois,-1
2021-03-19,@Belmont,0,11,Belmont,-11
2021-03-20,@Belmont,1,2,Belmont,-1
2021-03-20,@Belmont,5,2,Belmont,3
2021-03-24,@St. Louis,6,1,St. Louis,5
2021-03-26,@Southern Illinois-Edwardsville,11,9,Eastern Kentucky,2
2021-03-27,@Southern Illinois-Edwardsville,12,3,Eastern Kentucky,9
2021-03-27,@Southern Illinois-Edwardsville,8,5,Eastern Kentucky,3
2021-03-30,@Bradley,2,7,Bradley,-5
2021-04-02,@Morehead State,10,13,Morehead State,-3
2021-04-03,@Morehead State,8,13,Morehead State,-5
2021-04-03,@Morehead State,12,8,Morehead State,4
2021-04-06,@Southern Illinois-Edwardsville,16,10,St. Louis,6
2021-04-09,@Southern Illinois-Edwardsville,9,6,Tennessee-Martin,3
2021-04-09,@Southern Illinois-Edwardsville,8,7,Tennessee-Martin,1
2021-04-10,@Southern Illinois-Edwardsville,5,14,Tennessee-Martin,-9
2021-04-16,@Western Michigan,13,4,Western Michigan,9
2021-04-17,@Western Michigan,6,2,Western Michigan,4
2021-04-17,@Western Michigan,2,10,Western Michigan,-8
2021-04-18,@Western Michigan,8,1,Western Michigan,7
2021-04-23,@Austin Peay State,11,3,Austin Peay State,8
2021-04-23,@Austin Peay State,6,7,Austin Peay State,-1
2021-04-24,@Austin Peay State,6,7,Austin Peay State,-1
2021-04-27,@Illinois State,0,12,Illinois State,-12
2021-04-30,@Southern Illinois-Edwardsville,3,4,Eastern Illinois,-1
2021-05-01,@Southern Illinois-Edwardsville,10,15,Eastern Illinois,-5
2021-05-01,@Southern Illinois-Edwardsville,7,5,Eastern Illinois,2
2021-05-07,@Jacksonville State,4,3,Jacksonville State,1
2021-05-08,@Jacksonville State,4,2,Jacksonville State,2
2021-05-08,@Jacksonville State,0,10,Jacksonville State,-10
2021-05-11,@St. Louis,7,10,St. Louis,-3
2021-05-14,@Southern Illinois-Edwardsville,6,2,Murray State,4
2021-05-14,@Southern Illinois-Edwardsville,6,17,Murray State,-11
2021-05-15,@Southern Illinois-Edwardsville,6,7,Murray State,-1
2021-05-17,@Eastern Illinois,4,5,Eastern Illinois,-1
2021-05-20,@Tennessee Tech,4,9,Tennessee Tech,-5
2021-05-21,@Tennessee Tech,7,12,Tennessee Tech,-5
2021-05-21,@Tennessee Tech,12,13,Tennessee Tech,-1
2021-02-21,@Southern Mississippi,5,1,Northwestern State,4
2021-02-21,@Southern Mississippi,1,7,Northwestern State,-6
2021-02-22,@Southern Mississippi,10,0,Northwestern State,10
2021-02-23,@South Alabama,3,5,South Alabama,-2
2021-02-26,@Southern Mississippi,6,5,Connecticut,1
2021-02-27,@Southern Mississippi,7,6,Connecticut,1
2021-02-28,@Southern Mississippi,7,10,Connecticut,-3
2021-03-03,@Mississippi State,1,4,Mississippi State,-3
2021-03-05,@Jacksonville State,0,6,Jacksonville State,-6
2021-03-06,@Jacksonville State,6,0,Jacksonville State,6
2021-03-07,@Jacksonville State,3,1,Jacksonville State,2
2021-03-12,@Southern Mississippi,13,4,Louisiana-Lafayette,9
2021-03-13,@Southern Mississippi,1,0,Louisiana-Lafayette,1
2021-03-14,@Southern Mississippi,6,3,Louisiana-Lafayette,3
2021-03-16,@South Alabama,2,8,South Alabama,-6
2021-03-19,@Southern Mississippi,2,1,Missouri State,1
2021-03-20,@Southern Mississippi,5,0,Missouri State,5
2021-03-21,@Southern Mississippi,3,1,Missouri State,2
2021-03-23,@Alabama,5,4,Alabama,1
2021-03-26,@Southern Mississippi,2,3,Louisiana Tech,-1
2021-03-27,@Southern Mississippi,0,4,Louisiana Tech,-4
2021-03-27,@Southern Mississippi,14,6,Louisiana Tech,8
2021-03-28,@Southern Mississippi,7,8,Louisiana Tech,-1
2021-04-01,@Texas-San Antonio,9,1,Texas-San Antonio,8
2021-04-02,@Texas-San Antonio,13,9,Texas-San Antonio,4
2021-04-02,@Texas-San Antonio,11,5,Texas-San Antonio,6
2021-04-09,@Southern Mississippi,7,2,Alabama-Birmingham,5
2021-04-10,@Southern Mississippi,9,2,Alabama-Birmingham,7
2021-04-10,@Southern Mississippi,4,1,Alabama-Birmingham,3
2021-04-11,@Southern Mississippi,14,4,Alabama-Birmingham,10
2021-04-13,@Southern Mississippi,0,4,South Alabama,-4
2021-04-17,@Louisiana Tech,4,3,Louisiana Tech,1
2021-04-17,@Louisiana Tech,3,5,Louisiana Tech,-2
2021-04-18,@Louisiana Tech,12,11,Louisiana Tech,1
2021-04-18,@Louisiana Tech,6,7,Louisiana Tech,-1
2021-04-23,@Southern Mississippi,6,5,Western Kentucky,1
2021-04-24,@Southern Mississippi,6,5,Western Kentucky,1
2021-04-24,@Southern Mississippi,3,0,Western Kentucky,3
2021-04-25,@Southern Mississippi,4,9,Western Kentucky,-5
2021-04-30,@Rice,0,6,Rice,-6
2021-04-30,@Rice,12,1,Rice,11
2021-05-01,@Rice,10,1,Rice,9
2021-05-02,@Rice,8,1,Rice,7
2021-05-05,@Southern Mississippi,3,5,Southeastern Louisiana,-2
2021-05-07,@Southern Mississippi,2,1,Middle Tennessee State,1
2021-05-08,@Southern Mississippi,6,0,Middle Tennessee State,6
2021-05-08,@Southern Mississippi,9,0,Middle Tennessee State,9
2021-05-09,@Southern Mississippi,9,5,Middle Tennessee State,4
2021-05-14,@Florida Atlantic,1,3,Florida Atlantic,-2
2021-05-15,@Florida Atlantic,6,1,Florida Atlantic,5
2021-05-15,@Florida Atlantic,14,8,Florida Atlantic,6
2021-05-16,@Florida Atlantic,6,9,Florida Atlantic,-3
2021-05-26,@Southern Mississippi,11,1,Western Kentucky,10
2021-05-27,@Louisiana Tech,4,1,Louisiana Tech,3
2021-05-29,@Louisiana Tech,10,11,Louisiana Tech,-1
2021-05-29,@Louisiana Tech,5,6,Louisiana Tech,-1
2021-06-04,@Southern Mississippi,2,5,Florida State,-3
2021-06-05,@Southeast Missouri State,21,0,Southeast Missouri State,21
2021-06-06,@Southern Mississippi,10,7,Mississippi,3
2021-06-06,@Florida State,7,4,Florida State,3
2021-06-07,@Mississippi,9,12,Mississippi,-3
2021-03-20,@Youngstown State,4,6,Youngstown State,-2
2021-03-20,@Youngstown State,1,7,Youngstown State,-6
2021-03-21,@Youngstown State,6,22,Youngstown State,-16
2021-03-27,@St. Bonaventure,3,6,LaSalle,-3
2021-03-27,@St. Bonaventure,1,4,LaSalle,-3
2021-04-02,@George Mason,6,9,George Mason,-3
2021-04-03,@George Mason,8,3,George Mason,5
2021-04-03,@George Mason,1,2,George Mason,-1
2021-04-04,@George Mason,5,6,George Mason,-1
2021-04-09,@Fordham,1,4,Fordham,-3
2021-04-09,@Fordham,7,4,Fordham,3
2021-04-10,@Fordham,0,3,Fordham,-3
2021-04-10,@Fordham,5,7,Fordham,-2
2021-04-16,@St. Bonaventure,8,3,St. Joseph's,5
2021-04-17,@St. Bonaventure,6,0,St. Joseph's,6
2021-04-17,@St. Bonaventure,7,9,St. Joseph's,-2
2021-04-18,@St. Bonaventure,3,11,St. Joseph's,-8
2021-04-23,@LaSalle,2,10,LaSalle,-8
2021-04-24,@LaSalle,2,0,LaSalle,2
2021-04-24,@LaSalle,2,3,LaSalle,-1
2021-04-25,@LaSalle,2,8,LaSalle,-6
2021-05-01,@St. Bonaventure,2,13,Eastern Michigan,-11
2021-05-01,@St. Bonaventure,5,20,Eastern Michigan,-15
2021-05-07,@St. Bonaventure,3,8,Rhode Island,-5
2021-05-08,@St. Bonaventure,1,7,Rhode Island,-6
2021-05-08,@St. Bonaventure,3,2,Rhode Island,1
2021-05-09,@St. Bonaventure,4,8,Rhode Island,-4
2021-05-20,@St. Bonaventure,10,11,Fordham,-1
2021-05-21,@St. Bonaventure,1,2,Fordham,-1
2021-05-21,@St. Bonaventure,12,11,Fordham,1
2021-05-22,@St. Bonaventure,12,14,Fordham,-2
2021-02-26,@St. John's,2,1,Massachusetts-Lowell,1
2021-02-27,@St. John's,11,3,Massachusetts-Lowell,8
2021-02-28,@St. John's,3,1,Massachusetts-Lowell,2
2021-03-05,@St. John's,8,2,Sacred Heart,6
2021-03-06,@St. John's,16,4,Sacred Heart,12
2021-03-07,@St. John's,11,2,Sacred Heart,9
2021-03-07,@St. John's,12,1,Sacred Heart,11
2021-03-12,@Western Carolina,1,11,Western Carolina,-10
2021-03-13,@Western Carolina,3,21,Western Carolina,-18
2021-03-14,@Western Carolina,3,8,Western Carolina,-5
2021-03-19,@St. John's,4,1,Fordham,3
2021-03-20,@Fordham,4,3,Fordham,1
2021-03-20,@Fordham,6,7,Fordham,-1
2021-03-21,@St. John's,6,7,Fordham,-1
2021-04-09,@St. John's,2,1,Xavier,1
2021-04-10,@St. John's,3,12,Xavier,-9
2021-04-11,@St. John's,6,18,Xavier,-12
2021-04-16,@Georgetown,1,5,Georgetown,-4
2021-04-17,@Georgetown,7,11,Georgetown,-4
2021-04-17,@Georgetown,9,4,Georgetown,5
2021-04-18,@Georgetown,4,6,Georgetown,-2
2021-04-23,@St. John's,5,4,Seton Hall,1
2021-04-24,@St. John's,1,11,Seton Hall,-10
2021-04-24,@St. John's,4,19,Seton Hall,-15
2021-04-25,@St. John's,4,2,Seton Hall,2
2021-04-30,@Creighton,1,6,Creighton,-5
2021-05-01,@Creighton,4,11,Creighton,-7
2021-05-01,@Creighton,4,1,Creighton,3
2021-05-02,@Creighton,4,11,Creighton,-7
2021-05-07,@St. John's,3,4,Connecticut,-1
2021-05-08,@St. John's,0,6,Connecticut,-6
2021-05-08,@St. John's,4,3,Connecticut,1
2021-05-09,@St. John's,3,5,Connecticut,-2
2021-05-14,@Butler,9,0,Butler,9
2021-05-14,@Butler,4,0,Butler,4
2021-05-15,@Butler,9,4,Butler,5
2021-05-15,@Butler,1,4,Butler,-3
2021-05-20,@St. John's,4,5,Villanova,-1
2021-05-21,@St. John's,2,7,Villanova,-5
2021-05-22,@St. John's,6,1,Villanova,5
2021-03-10,@Towson,12,3,Towson,9
2021-03-13,@George Washington,4,1,George Washington,3
2021-03-14,@George Washington,13,12,George Washington,1
2021-03-14,@George Washington,16,14,George Washington,2
2021-03-19,@St. Joseph's,4,6,Connecticut,-2
2021-03-20,@St. Joseph's,9,8,Connecticut,1
2021-03-21,@St. Joseph's,0,13,Connecticut,-13
2021-04-01,@St. Joseph's,7,8,Villanova,-1
2021-04-03,@St. Joseph's,5,16,Villanova,-11
2021-04-03,@St. Joseph's,2,8,Villanova,-6
2021-04-06,@St. Joseph's,3,4,Army,-1
2021-04-09,@St. Joseph's,7,5,Massachusetts,2
2021-04-09,@St. Joseph's,5,1,Massachusetts,4
2021-04-10,@St. Joseph's,6,1,Massachusetts,5
2021-04-10,@St. Joseph's,10,2,Massachusetts,8
2021-04-16,@St. Bonaventure,3,8,St. Bonaventure,-5
2021-04-17,@St. Bonaventure,9,7,St. Bonaventure,2
2021-04-17,@St. Bonaventure,0,6,St. Bonaventure,-6
2021-04-18,@St. Bonaventure,11,3,St. Bonaventure,8
2021-04-23,@St. Joseph's,13,3,Fordham,10
2021-04-24,@St. Joseph's,11,1,Fordham,10
2021-04-24,@St. Joseph's,1,3,Fordham,-2
2021-04-25,@St. Joseph's,2,3,Fordham,-1
2021-05-02,@James Madison,8,9,James Madison,-1
2021-05-02,@James Madison,8,9,James Madison,-1
2021-05-05,@St. Joseph's,5,4,Bucknell,1
2021-05-07,@LaSalle,0,5,LaSalle,-5
2021-05-08,@LaSalle,3,8,LaSalle,-5
2021-05-08,@LaSalle,4,3,LaSalle,1
2021-05-09,@LaSalle,5,14,LaSalle,-9
2021-05-14,@Rhode Island,6,5,Rhode Island,1
2021-05-15,@Rhode Island,3,7,Rhode Island,-4
2021-05-15,@Rhode Island,7,8,Rhode Island,-1
2021-05-16,@Rhode Island,6,3,Rhode Island,3
2021-05-20,@St. Joseph's,3,2,LaSalle,1
2021-05-21,@St. Joseph's,3,2,LaSalle,1
2021-05-21,@St. Joseph's,11,2,LaSalle,9
2021-05-22,@St. Joseph's,5,2,LaSalle,3
2021-05-27,@St. Joseph's,5,11,Dayton,-6
2021-05-27,@Virginia Commonwealth,4,15,Virginia Commonwealth,-11
2021-02-19,@Kennesaw State,8,7,Kennesaw State,1
2021-02-20,@Kennesaw State,1,5,Kennesaw State,-4
2021-02-20,@Kennesaw State,1,2,Kennesaw State,-1
2021-02-21,@Kennesaw State,4,5,Kennesaw State,-1
2021-02-26,@St. Louis,4,7,North Dakota State,-3
2021-02-27,@St. Louis,5,6,North Dakota State,-1
2021-02-27,@St. Louis,4,5,North Dakota State,-1
2021-03-02,@Southern Illinois-Edwardsville,1,11,Southern Illinois-Edwardsville,-10
2021-03-05,@St. Louis,8,1,Kansas,7
2021-03-06,@St. Louis,1,5,Kansas,-4
2021-03-07,@St. Louis,5,7,Kansas,-2
2021-03-10,@St. Louis,1,2,Missouri,-1
2021-03-12,@St. Louis,4,3,Western Illinois,1
2021-03-13,@St. Louis,0,11,Western Illinois,-11
2021-03-14,@St. Louis,14,0,Western Illinois,14
2021-03-16,@St. Louis,6,8,Southeast Missouri State,-2
2021-03-19,@St. Louis,7,14,Oral Roberts,-7
2021-03-20,@St. Louis,6,2,Oral Roberts,4
2021-03-21,@St. Louis,4,1,Oral Roberts,3
2021-03-24,@St. Louis,1,6,Southern Illinois-Edwardsville,-5
2021-03-26,@Cincinnati,4,8,Cincinnati,-4
2021-03-27,@Cincinnati,5,8,Cincinnati,-3
2021-03-28,@Cincinnati,21,6,Cincinnati,15
2021-04-01,@St. Louis,2,8,Indiana State,-6
2021-04-02,@St. Louis,2,13,Indiana State,-11
2021-04-03,@St. Louis,8,5,Indiana State,3
2021-04-06,@Southern Illinois-Edwardsville,10,16,Southern Illinois-Edwardsville,-6
2021-04-09,@George Mason,3,7,George Mason,-4
2021-04-09,@George Mason,6,4,George Mason,2
2021-04-10,@George Mason,7,0,George Mason,7
2021-04-11,@George Mason,4,2,George Mason,2
2021-04-21,@St. Louis,13,0,Fontbonne,13
2021-04-23,@Bradley,4,18,Bradley,-14
2021-04-24,@Bradley,9,6,Bradley,3
2021-04-25,@Bradley,3,13,Bradley,-10
2021-04-30,@George Washington,7,10,George Washington,-3
2021-05-01,@George Washington,7,2,George Washington,5
2021-05-01,@George Washington,7,14,George Washington,-7
2021-05-02,@George Washington,9,7,George Washington,2
2021-05-07,@St. Louis,6,14,Virginia Commonwealth,-8
2021-05-07,@St. Louis,4,19,Virginia Commonwealth,-15
2021-05-08,@St. Louis,5,16,Virginia Commonwealth,-11
2021-05-08,@St. Louis,8,9,Virginia Commonwealth,-1
2021-05-11,@St. Louis,10,7,Southern Illinois-Edwardsville,3
2021-05-20,@St. Louis,3,11,Davidson,-8
2021-05-21,@St. Louis,7,5,Davidson,2
2021-05-21,@St. Louis,1,4,Davidson,-3
2021-05-22,@St. Louis,3,6,Davidson,-3
2021-04-10,@St. Peter's,5,0,Niagara,5
2021-04-10,@St. Peter's,1,12,Niagara,-11
2021-04-11,@St. Peter's,4,13,Niagara,-9
2021-04-11,@St. Peter's,0,9,Niagara,-9
2021-04-17,@St. Peter's,3,0,Marist,3
2021-04-17,@St. Peter's,2,7,Marist,-5
2021-04-18,@St. Peter's,3,13,Marist,-10
2021-04-18,@St. Peter's,1,9,Marist,-8
2021-04-21,@St. Peter's,0,9,Fairfield,-9
2021-04-21,@St. Peter's,2,20,Fairfield,-18
2021-04-23,@Siena,0,10,Siena,-10
2021-04-23,@Siena,1,8,Siena,-7
2021-04-24,@Siena,1,14,Siena,-13
2021-04-24,@Siena,0,7,Siena,-7
2021-05-01,@Rider,2,12,Rider,-10
2021-05-01,@Rider,0,5,Rider,-5
2021-05-02,@Rider,1,14,Rider,-13
2021-05-02,@Rider,3,17,Rider,-14
2021-05-08,@St. Peter's,1,0,Monmouth,1
2021-05-08,@St. Peter's,0,5,Monmouth,-5
2021-05-09,@St. Peter's,0,18,Monmouth,-18
2021-05-09,@St. Peter's,5,18,Monmouth,-13
2021-05-12,@Canisius,11,20,Canisius,-9
2021-05-12,@Canisius,0,21,Canisius,-21
2021-05-15,@Manhattan,3,4,Manhattan,-1
2021-05-15,@Manhattan,1,12,Manhattan,-11
2021-05-16,@Manhattan,8,7,Manhattan,1
2021-05-16,@Manhattan,4,5,Manhattan,-1
2021-02-25,@Stanford,10,7,Santa Clara,3
2021-02-26,@Santa Clara,8,0,Santa Clara,8
2021-02-27,@Stanford,10,6,Santa Clara,4
2021-02-28,@Santa Clara,0,13,Santa Clara,-13
2021-03-04,@Stanford,7,6,San Francisco,1
2021-03-05,@Stanford,3,2,San Francisco,1
2021-03-06,@San Francisco,10,6,San Francisco,4
2021-03-07,@San Francisco,15,13,San Francisco,2
2021-03-12,@Stanford,4,1,UC Irvine,3
2021-03-13,@Stanford,6,1,UC Irvine,5
2021-03-13,@Stanford,1,5,UC Irvine,-4
2021-03-14,@Stanford,8,6,UC Irvine,2
2021-03-19,@Stanford,4,2,Utah,2
2021-03-20,@Stanford,4,8,Utah,-4
2021-03-21,@Stanford,4,1,Utah,3
2021-03-27,@Stanford,12,4,Fresno State,8
2021-03-28,@Stanford,11,8,Fresno State,3
2021-03-29,@Sacramento State,2,3,Sacramento State,-1
2021-04-01,@Washington State,18,3,Washington State,15
2021-04-02,@Washington State,7,5,Washington State,2
2021-04-03,@Washington State,9,10,Washington State,-1
2021-04-06,@Stanford,4,3,California,1
2021-04-09,@Stanford,6,2,UCLA,4
2021-04-10,@Stanford,11,6,UCLA,5
2021-04-11,@Stanford,1,6,UCLA,-5
2021-04-14,@Stanford,2,0,Pacific,2
2021-04-16,@Arizona State,5,9,Arizona State,-4
2021-04-17,@Arizona State,11,9,Arizona State,2
2021-04-18,@Arizona State,13,5,Arizona State,8
2021-04-28,@Pacific,12,15,Pacific,-3
2021-04-30,@Southern California,5,2,Southern California,3
2021-05-01,@Southern California,3,2,Southern California,1
2021-05-02,@Southern California,1,2,Southern California,-1
2021-05-07,@Stanford,5,4,Arizona,1
2021-05-08,@Stanford,2,20,Arizona,-18
2021-05-09,@Stanford,8,2,Arizona,6
2021-05-11,@Stanford,8,7,San Jose State,1
2021-05-14,@California,9,2,California,7
2021-05-15,@California,4,5,California,-1
2021-05-16,@California,5,9,California,-4
2021-05-17,@Stanford,7,6,California,1
2021-05-21,@Oregon,1,2,Oregon,-1
2021-05-22,@Oregon,6,5,Oregon,1
2021-05-23,@Oregon,8,5,Oregon,3
2021-05-27,@Stanford,1,0,Oregon State,1
2021-05-28,@Stanford,5,0,Oregon State,5
2021-05-29,@Stanford,1,9,Oregon State,-8
2021-06-04,@Stanford,9,1,North Dakota State,8
2021-06-05,@Stanford,12,4,UC Irvine,8
2021-06-06,@UC Irvine,4,8,UC Irvine,-4
2021-06-07,@UC Irvine,11,8,UC Irvine,3
2021-06-11,@Texas Tech,15,3,Texas Tech,12
2021-06-12,@Stanford,9,0,Texas Tech,9
2021-06-19,@Stanford,4,10,North Carolina State,-6
2021-06-21,@Arizona,14,5,Arizona,9
2021-06-23,@Vanderbilt,5,6,Vanderbilt,-1
2021-02-23,@Oklahoma,9,5,Oklahoma,4
2021-02-26,@Texas-Arlington,5,2,Texas-Arlington,3
2021-02-27,@Texas-Arlington,3,5,Texas-Arlington,-2
2021-02-27,@Texas-Arlington,1,2,Texas-Arlington,-1
2021-03-02,@Texas Christian,3,9,Texas Christian,-6
2021-03-05,@Lamar,1,4,Lamar,-3
2021-03-06,@Lamar,1,5,Lamar,-4
2021-03-07,@Lamar,2,3,Lamar,-1
2021-03-12,@Nicholls State,6,8,Nicholls State,-2
2021-03-13,@Nicholls State,2,3,Nicholls State,-1
2021-03-13,@Nicholls State,1,2,Nicholls State,-1
2021-03-14,@Nicholls State,1,2,Nicholls State,-1
2021-03-19,@Stephen F. Austin State,4,6,New Orleans,-2
2021-03-20,@Stephen F. Austin State,4,8,New Orleans,-4
2021-03-20,@Stephen F. Austin State,5,4,New Orleans,1
2021-03-21,@Stephen F. Austin State,5,3,New Orleans,2
2021-03-26,@McNeese State,8,5,McNeese State,3
2021-03-27,@McNeese State,4,3,McNeese State,1
2021-03-27,@McNeese State,5,2,McNeese State,3
2021-03-28,@McNeese State,2,0,McNeese State,2
2021-04-01,@Stephen F. Austin State,14,0,Incarnate Word,14
2021-04-02,@Stephen F. Austin State,9,15,Incarnate Word,-6
2021-04-02,@Stephen F. Austin State,11,1,Incarnate Word,10
2021-04-03,@Stephen F. Austin State,11,1,Incarnate Word,10
2021-04-06,@Stephen F. Austin State,10,8,Grambling State,2
2021-04-07,@Texas,1,9,Texas,-8
2021-04-13,@Texas Tech,3,4,Texas Tech,-1
2021-04-14,@Texas Tech,5,7,Texas Tech,-2
2021-04-17,@Stephen F. Austin State,2,6,Southeastern Louisiana,-4
2021-04-17,@Stephen F. Austin State,4,7,Southeastern Louisiana,-3
2021-04-18,@Stephen F. Austin State,6,9,Southeastern Louisiana,-3
2021-04-18,@Stephen F. Austin State,3,5,Southeastern Louisiana,-2
2021-04-23,@Central Arkansas,9,10,Central Arkansas,-1
2021-04-24,@Central Arkansas,8,2,Central Arkansas,6
2021-04-25,@Central Arkansas,6,7,Central Arkansas,-1
2021-04-25,@Central Arkansas,0,9,Central Arkansas,-9
2021-04-30,@Stephen F. Austin State,6,3,Sam Houston State,3
2021-05-01,@Stephen F. Austin State,5,4,Sam Houston State,1
2021-05-01,@Stephen F. Austin State,3,9,Sam Houston State,-6
2021-05-07,@Texas A&M-Corpus Christi,1,5,Texas A&M-Corpus Christi,-4
2021-05-08,@Texas A&M-Corpus Christi,2,5,Texas A&M-Corpus Christi,-3
2021-05-08,@Texas A&M-Corpus Christi,2,10,Texas A&M-Corpus Christi,-8
2021-05-09,@Texas A&M-Corpus Christi,5,3,Texas A&M-Corpus Christi,2
2021-05-14,@Stephen F. Austin State,8,3,Northwestern State,5
2021-05-15,@Stephen F. Austin State,9,4,Northwestern State,5
2021-05-15,@Stephen F. Austin State,4,5,Northwestern State,-1
2021-05-16,@Stephen F. Austin State,7,2,Northwestern State,5
2021-05-20,@Abilene Christian,3,13,Abilene Christian,-10
2021-05-21,@Abilene Christian,4,6,Abilene Christian,-2
2021-05-21,@Abilene Christian,3,7,Abilene Christian,-4
2021-05-22,@Abilene Christian,9,3,Abilene Christian,6
2021-02-20,@Stetson,1,0,Florida A&M,1
2021-02-20,@Stetson,6,3,Florida A&M,3
2021-02-21,@Stetson,3,1,Florida A&M,2
2021-02-21,@Stetson,6,0,Florida A&M,6
2021-02-23,@Central Florida,7,0,Central Florida,7
2021-02-26,@Stetson,8,3,North Alabama,5
2021-02-27,@Stetson,16,5,North Alabama,11
2021-02-27,@Stetson,6,0,North Alabama,6
2021-02-28,@Stetson,7,2,North Alabama,5
2021-03-03,@Stetson,6,5,Central Florida,1
2021-03-05,@Stetson,2,3,South Florida,-1
2021-03-06,@Stetson,5,10,South Florida,-5
2021-03-07,@South Florida,5,6,South Florida,-1
2021-03-10,@Florida,7,10,Florida,-3
2021-03-12,@Alabama,4,2,Alabama,2
2021-03-13,@Alabama,3,4,Alabama,-1
2021-03-14,@Alabama,4,9,Alabama,-5
2021-03-16,@South Florida,14,12,South Florida,2
2021-03-19,@Stetson,9,4,Wichita State,5
2021-03-20,@Stetson,8,11,Wichita State,-3
2021-03-23,@Florida International,6,3,Florida International,3
2021-03-26,@Stetson,7,5,Florida Gulf Coast,2
2021-03-27,@Stetson,6,13,Florida Gulf Coast,-7
2021-03-28,@Stetson,13,4,Florida Gulf Coast,9
2021-03-30,@South Florida,3,7,South Florida,-4
2021-04-01,@Jacksonville,11,1,Jacksonville,10
2021-04-02,@Jacksonville,7,5,Jacksonville,2
2021-04-03,@Jacksonville,3,2,Jacksonville,1
2021-04-06,@Florida,6,7,Florida,-1
2021-04-16,@Stetson,3,7,North Florida,-4
2021-04-17,@Stetson,16,4,North Florida,12
2021-04-18,@Stetson,1,7,North Florida,-6
2021-04-21,@Florida International,6,7,Florida International,-1
2021-04-23,@Florida Gulf Coast,3,4,Florida Gulf Coast,-1
2021-04-24,@Florida Gulf Coast,4,2,Florida Gulf Coast,2
2021-04-25,@Florida Gulf Coast,7,5,Florida Gulf Coast,2
2021-04-27,@Florida State,5,9,Florida State,-4
2021-04-30,@Stetson,5,0,Jacksonville,5
2021-05-01,@Stetson,5,7,Jacksonville,-2
2021-05-02,@Stetson,2,5,Jacksonville,-3
2021-05-04,@Florida,6,9,Florida,-3
2021-05-07,@North Florida,5,6,North Florida,-1
2021-05-08,@North Florida,3,5,North Florida,-2
2021-05-09,@North Florida,5,4,North Florida,1
2021-05-11,@Stetson,6,1,Florida,5
2021-05-15,@Stetson,15,3,Jacksonville,12
2021-05-16,@North Florida,2,3,North Florida,-1
2021-05-21,@North Florida,4,5,North Florida,-1
2021-05-22,@North Florida,2,9,North Florida,-7
2021-02-26,@Stony Brook,1,0,Sacred Heart,1
2021-02-26,@Stony Brook,7,1,Sacred Heart,6
2021-02-28,@Stony Brook,0,2,Sacred Heart,-2
2021-03-07,@Stony Brook,4,9,Massachusetts,-5
2021-03-07,@Stony Brook,1,3,Massachusetts,-2
2021-03-09,@Stony Brook,7,9,Fordham,-2
2021-03-12,@Central Connecticut State,4,3,Central Connecticut State,1
2021-03-13,@Central Connecticut State,9,3,Central Connecticut State,6
2021-03-14,@Central Connecticut State,1,4,Central Connecticut State,-3
2021-03-20,@Stony Brook,1,2,Villanova,-1
2021-03-21,@Villanova,3,8,Villanova,-5
2021-03-26,@Albany,14,11,Albany,3
2021-03-27,@Albany,9,3,Albany,6
2021-03-27,@Albany,14,6,Albany,8
2021-03-28,@Albany,11,0,Albany,11
2021-04-02,@Stony Brook,5,2,Hartford,3
2021-04-02,@Stony Brook,7,1,Hartford,6
2021-04-03,@Stony Brook,6,5,Hartford,1
2021-04-03,@Stony Brook,6,2,Hartford,4
2021-04-09,@Massachusetts-Lowell,6,2,Massachusetts-Lowell,4
2021-04-09,@Massachusetts-Lowell,5,4,Massachusetts-Lowell,1
2021-04-10,@Massachusetts-Lowell,9,2,Massachusetts-Lowell,7
2021-04-10,@Massachusetts-Lowell,3,4,Massachusetts-Lowell,-1
2021-04-17,@Stony Brook,6,4,Maryland-Baltimore County,2
2021-04-17,@Stony Brook,3,2,Maryland-Baltimore County,1
2021-04-18,@Stony Brook,8,7,Maryland-Baltimore County,1
2021-04-18,@Stony Brook,7,5,Maryland-Baltimore County,2
2021-04-24,@Stony Brook,5,6,New Jersey Tech,-1
2021-04-24,@Stony Brook,2,3,New Jersey Tech,-1
2021-04-25,@New Jersey Tech,8,9,New Jersey Tech,-1
2021-04-25,@New Jersey Tech,5,2,New Jersey Tech,3
2021-05-01,@Stony Brook,13,9,Binghamton,4
2021-05-01,@Stony Brook,0,10,Binghamton,-10
2021-05-02,@Stony Brook,2,6,Binghamton,-4
2021-05-02,@Stony Brook,5,1,Binghamton,4
2021-05-08,@Stony Brook,0,2,New Jersey Tech,-2
2021-05-08,@Stony Brook,11,3,New Jersey Tech,8
2021-05-09,@Stony Brook,5,7,New Jersey Tech,-2
2021-05-09,@Stony Brook,4,3,New Jersey Tech,1
2021-05-15,@Maryland-Baltimore County,7,8,Maryland-Baltimore County,-1
2021-05-15,@Maryland-Baltimore County,13,1,Maryland-Baltimore County,12
2021-05-16,@Maryland-Baltimore County,6,0,Maryland-Baltimore County,6
2021-05-21,@Binghamton,7,1,Binghamton,6
2021-05-21,@Binghamton,15,3,Binghamton,12
2021-05-22,@Binghamton,6,3,Binghamton,3
2021-05-22,@Binghamton,4,5,Binghamton,-1
2021-05-27,@Stony Brook,2,4,Maine,-2
2021-05-28,@Stony Brook,3,2,Albany,1
2021-05-29,@Stony Brook,15,9,Maine,6
2021-02-20,@Abilene Christian,2,7,Abilene Christian,-5
2021-02-20,@Abilene Christian,3,16,Abilene Christian,-13
2021-02-21,@Tarleton State,10,4,Abilene Christian,6
2021-02-23,@Texas-Arlington,1,14,Texas-Arlington,-13
2021-02-24,@Texas A&M,7,8,Texas A&M,-1
2021-02-26,@Northwestern State,3,0,Northwestern State,3
2021-02-27,@Northwestern State,3,5,Northwestern State,-2
2021-02-27,@Northwestern State,1,2,Northwestern State,-1
2021-03-02,@Tarleton State,23,1,Arkansas-Pine Bluff,22
2021-03-03,@Tarleton State,16,6,Arkansas-Pine Bluff,10
2021-03-05,@Central Arkansas,1,6,Central Arkansas,-5
2021-03-06,@Central Arkansas,2,19,Central Arkansas,-17
2021-03-06,@Missouri State,7,5,Missouri State,2
2021-03-10,@Tarleton State,10,6,Lamar,4
2021-03-12,@Tarleton State,0,6,Sacramento State,-6
2021-03-12,@Tarleton State,3,17,Sacramento State,-14
2021-03-13,@Tarleton State,16,13,Sacramento State,3
2021-03-14,@Tarleton State,5,20,Sacramento State,-15
2021-03-18,@Dallas Baptist,5,4,Dallas Baptist,1
2021-03-19,@Dallas Baptist,3,10,Dallas Baptist,-7
2021-03-20,@Dallas Baptist,5,8,Dallas Baptist,-3
2021-03-26,@California Baptist,2,6,California Baptist,-4
2021-03-27,@California Baptist,3,7,California Baptist,-4
2021-03-27,@California Baptist,3,6,California Baptist,-3
2021-03-28,@California Baptist,1,3,California Baptist,-2
2021-04-01,@Tarleton State,10,9,Dixie State,1
2021-04-02,@Tarleton State,1,5,Dixie State,-4
2021-04-02,@Tarleton State,4,7,Dixie State,-3
2021-04-03,@Tarleton State,9,13,Dixie State,-4
2021-04-06,@Tarleton State,9,13,Texas Christian,-4
2021-04-09,@Seattle,4,2,Seattle,2
2021-04-10,@Seattle,6,5,Seattle,1
2021-04-10,@Seattle,2,3,Seattle,-1
2021-04-11,@Seattle,3,0,Seattle,3
2021-04-13,@Texas Christian,2,10,Texas Christian,-8
2021-04-16,@Utah Valley,4,3,Utah Valley,1
2021-04-17,@Utah Valley,9,7,Utah Valley,2
2021-04-17,@Utah Valley,8,1,Utah Valley,7
2021-04-18,@Utah Valley,4,8,Utah Valley,-4
2021-04-23,@Tarleton State,12,8,New Mexico State,4
2021-04-24,@Tarleton State,4,1,New Mexico State,3
2021-04-24,@Tarleton State,3,8,New Mexico State,-5
2021-04-25,@Tarleton State,6,17,New Mexico State,-11
2021-04-30,@Northern Colorado,9,15,Northern Colorado,-6
2021-05-01,@Northern Colorado,11,4,Northern Colorado,7
2021-05-01,@Northern Colorado,5,6,Northern Colorado,-1
2021-05-02,@Northern Colorado,21,5,Northern Colorado,16
2021-05-07,@Texas-Rio Grande Valley,2,3,Texas-Rio Grande Valley,-1
2021-05-08,@Texas-Rio Grande Valley,7,9,Texas-Rio Grande Valley,-2
2021-05-08,@Texas-Rio Grande Valley,7,6,Texas-Rio Grande Valley,1
2021-05-09,@Texas-Rio Grande Valley,1,11,Texas-Rio Grande Valley,-10
2021-05-14,@Tarleton State,7,16,Grand Canyon,-9
2021-05-15,@Tarleton State,4,12,Grand Canyon,-8
2021-05-15,@Tarleton State,3,7,Grand Canyon,-4
2021-05-16,@Tarleton State,4,9,Grand Canyon,-5
2021-02-19,@Georgia Southern,5,3,Georgia Southern,2
2021-02-20,@Georgia Southern,5,3,Georgia Southern,2
2021-02-21,@Georgia Southern,7,3,Georgia Southern,4
2021-02-23,@Tennessee,21,1,Arkansas-Pine Bluff,20
2021-02-24,@Tennessee,14,6,Arkansas-Pine Bluff,8
2021-02-26,@Tennessee,4,3,Indiana State,1
2021-02-27,@Tennessee,5,7,Indiana State,-2
2021-02-27,@Tennessee,1,3,Indiana State,-2
2021-02-28,@Tennessee,6,5,Indiana State,1
2021-03-03,@Austin Peay State,5,3,Austin Peay State,2
2021-03-05,@Tennessee,6,1,Georgia State,5
2021-03-06,@Tennessee,5,1,Georgia State,4
2021-03-07,@Tennessee,7,0,Georgia State,7
2021-03-09,@North Carolina-Charlotte,0,9,North Carolina-Charlotte,-9
2021-03-12,@Tennessee,6,2,North Carolina-Greensboro,4
2021-03-13,@Tennessee,14,9,North Carolina-Greensboro,5
2021-03-14,@Tennessee,9,3,North Carolina-Greensboro,6
2021-03-16,@Tennessee,9,6,East Tennessee State,3
2021-03-19,@Georgia,11,6,Georgia,5
2021-03-20,@Georgia,4,5,Georgia,-1
2021-03-21,@Georgia,4,1,Georgia,3
2021-03-23,@Tennessee,13,5,Eastern Kentucky,8
2021-03-26,@Tennessee,3,1,Louisiana State,2
2021-03-28,@Tennessee,3,2,Louisiana State,1
2021-03-28,@Tennessee,9,8,Louisiana State,1
2021-03-30,@Tennessee,9,2,Western Carolina,7
2021-04-02,@Alabama,4,7,Alabama,-3
2021-04-03,@Alabama,8,4,Alabama,4
2021-04-04,@Alabama,9,8,Alabama,1
2021-04-06,@Tennessee,10,1,Eastern Kentucky,9
2021-04-09,@Tennessee,6,4,Florida,2
2021-04-10,@Tennessee,5,4,Florida,1
2021-04-11,@Tennessee,6,7,Florida,-1
2021-04-13,@Western Carolina,14,12,Western Carolina,2
2021-04-16,@Tennessee,0,5,Vanderbilt,-5
2021-04-17,@Tennessee,8,4,Vanderbilt,4
2021-04-18,@Tennessee,4,10,Vanderbilt,-6
2021-04-20,@Tennessee,3,2,Tennessee Tech,1
2021-04-24,@Texas A&M,6,1,Texas A&M,5
2021-04-24,@Texas A&M,5,6,Texas A&M,-1
2021-04-25,@Texas A&M,20,7,Texas A&M,13
2021-04-27,@Tennessee,1,4,Lipscomb,-3
2021-04-29,@Tennessee,14,4,Kentucky,10
2021-04-30,@Tennessee,2,8,Kentucky,-6
2021-05-01,@Tennessee,11,2,Kentucky,9
2021-05-07,@Missouri,5,4,Missouri,1
2021-05-08,@Missouri,11,4,Missouri,7
2021-05-09,@Missouri,10,2,Missouri,8
2021-05-11,@Tennessee,10,8,Tennessee Tech,2
2021-05-14,@Tennessee,5,6,Arkansas,-1
2021-05-15,@Tennessee,8,7,Arkansas,1
2021-05-16,@Tennessee,2,3,Arkansas,-1
2021-05-18,@Tennessee,11,2,Belmont,9
2021-05-20,@South Carolina,10,4,South Carolina,6
2021-05-21,@South Carolina,2,3,South Carolina,-1
2021-05-22,@South Carolina,5,4,South Carolina,1
2021-05-26,@Tennessee,2,3,Alabama,-1
2021-05-27,@Tennessee,12,2,Mississippi State,10
2021-05-28,@Alabama,11,0,Alabama,11
2021-05-29,@Florida,4,0,Florida,4
2021-05-30,@Tennessee,2,7,Arkansas,-5
2021-06-04,@Tennessee,9,8,Wright State,1
2021-06-05,@Liberty,9,3,Liberty,6
2021-06-06,@Tennessee,3,1,Liberty,2
2021-06-12,@Tennessee,4,2,Louisiana State,2
2021-06-13,@Louisiana State,15,6,Louisiana State,9
2021-06-20,@Tennessee,0,6,Virginia,-6
2021-06-22,@Texas,4,8,Texas,-4
2021-02-20,@Tennessee Tech,5,3,Alabama State,2
2021-02-20,@Southern Illinois,3,4,Southern Illinois,-1
2021-02-21,@Jacksonville State,5,4,Jacksonville State,1
2021-02-27,@Kent State,1,6,Kent State,-5
2021-02-27,@Kent State,5,17,Kent State,-12
2021-02-28,@Kent State,1,8,Kent State,-7
2021-03-02,@Tennessee Tech,7,2,North Alabama,5
2021-03-13,@Austin Peay State,13,6,Austin Peay State,7
2021-03-14,@Austin Peay State,2,6,Austin Peay State,-4
2021-03-14,@Austin Peay State,12,0,Austin Peay State,12
2021-03-16,@North Alabama,18,4,North Alabama,14
2021-03-20,@Tennessee Tech,6,18,Eastern Illinois,-12
2021-03-20,@Tennessee Tech,9,8,Eastern Illinois,1
2021-03-21,@Tennessee Tech,9,1,Eastern Illinois,8
2021-03-23,@Tennessee Tech,11,4,Belmont,7
2021-03-26,@Jacksonville State,3,8,Jacksonville State,-5
2021-03-27,@Jacksonville State,0,8,Jacksonville State,-8
2021-03-27,@Jacksonville State,0,5,Jacksonville State,-5
2021-03-30,@Vanderbilt,5,12,Vanderbilt,-7
2021-04-01,@Tennessee Tech,2,4,Murray State,-2
2021-04-02,@Tennessee Tech,2,7,Murray State,-5
2021-04-02,@Tennessee Tech,5,4,Murray State,1
2021-04-10,@College of Charleston,6,9,College of Charleston,-3
2021-04-10,@College of Charleston,5,4,College of Charleston,1
2021-04-11,@College of Charleston,0,8,College of Charleston,-8
2021-04-16,@Southeast Missouri State,3,7,Southeast Missouri State,-4
2021-04-17,@Southeast Missouri State,2,7,Southeast Missouri State,-5
2021-04-17,@Southeast Missouri State,9,1,Southeast Missouri State,8
2021-04-20,@Tennessee,2,3,Tennessee,-1
2021-04-24,@Tennessee Tech,9,7,Belmont,2
2021-04-25,@Tennessee Tech,7,9,Belmont,-2
2021-04-25,@Tennessee Tech,8,9,Belmont,-1
2021-04-27,@Belmont,7,6,Belmont,1
2021-04-30,@Eastern Kentucky,5,10,Eastern Kentucky,-5
2021-05-01,@Eastern Kentucky,16,3,Eastern Kentucky,13
2021-05-01,@Eastern Kentucky,3,9,Eastern Kentucky,-6
2021-05-07,@Tennessee Tech,3,2,Morehead State,1
2021-05-08,@Tennessee Tech,8,7,Morehead State,1
2021-05-08,@Tennessee Tech,4,3,Morehead State,1
2021-05-11,@Tennessee,8,10,Tennessee,-2
2021-05-14,@Tennessee-Martin,8,9,Tennessee-Martin,-1
2021-05-15,@Tennessee-Martin,15,9,Tennessee-Martin,6
2021-05-15,@Tennessee-Martin,4,7,Tennessee-Martin,-3
2021-05-18,@Kentucky,4,8,Kentucky,-4
2021-05-20,@Tennessee Tech,9,4,Southern Illinois-Edwardsville,5
2021-05-21,@Tennessee Tech,12,7,Southern Illinois-Edwardsville,5
2021-05-21,@Tennessee Tech,13,12,Southern Illinois-Edwardsville,1
2021-02-19,@Samford,3,5,Samford,-2
2021-02-20,@Samford,4,5,Samford,-1
2021-02-21,@Samford,1,3,Samford,-2
2021-02-24,@Alabama,9,4,Alabama,5
2021-02-27,@Arkansas State,21,5,Arkansas State,16
2021-02-27,@Arkansas State,8,5,Arkansas State,3
2021-03-05,@Southern Illinois,7,14,Southern Illinois,-7
2021-03-06,@Southern Illinois,4,8,Southern Illinois,-4
2021-03-07,@Southern Illinois,3,8,Southern Illinois,-5
2021-03-09,@North Alabama,5,1,North Alabama,4
2021-03-11,@Tennessee-Martin,9,6,Belmont,3
2021-03-12,@Tennessee-Martin,0,8,Belmont,-8
2021-03-12,@Tennessee-Martin,10,5,Belmont,5
2021-03-20,@Eastern Kentucky,1,6,Eastern Kentucky,-5
2021-03-20,@Eastern Kentucky,7,3,Eastern Kentucky,4
2021-03-21,@Eastern Kentucky,2,3,Eastern Kentucky,-1
2021-03-27,@Grambling State,18,4,Grambling State,14
2021-03-28,@Grambling State,2,5,Grambling State,-3
2021-03-28,@Grambling State,6,5,Grambling State,1
2021-03-30,@Belmont,8,9,Belmont,-1
2021-04-01,@Nicholls State,1,2,Nicholls State,-1
2021-04-02,@Nicholls State,0,7,Nicholls State,-7
2021-04-03,@Nicholls State,2,0,Nicholls State,2
2021-04-06,@Vanderbilt,4,5,Vanderbilt,-1
2021-04-09,@Southern Illinois-Edwardsville,6,9,Southern Illinois-Edwardsville,-3
2021-04-09,@Southern Illinois-Edwardsville,7,8,Southern Illinois-Edwardsville,-1
2021-04-10,@Southern Illinois-Edwardsville,14,5,Southern Illinois-Edwardsville,9
2021-04-13,@Tennessee-Martin,1,8,Southeast Missouri State,-7
2021-04-16,@Tennessee-Martin,1,8,Austin Peay State,-7
2021-04-17,@Tennessee-Martin,1,0,Austin Peay State,1
2021-04-17,@Tennessee-Martin,6,10,Austin Peay State,-4
2021-04-22,@Eastern Illinois,5,1,Eastern Illinois,4
2021-04-23,@Eastern Illinois,5,2,Eastern Illinois,3
2021-04-23,@Eastern Illinois,0,7,Eastern Illinois,-7
2021-04-27,@Arkansas-Pine Bluff,3,2,Arkansas-Pine Bluff,1
2021-04-30,@Tennessee-Martin,1,6,Jacksonville State,-5
2021-05-01,@Tennessee-Martin,4,14,Jacksonville State,-10
2021-05-01,@Tennessee-Martin,8,12,Jacksonville State,-4
2021-05-07,@Murray State,5,8,Murray State,-3
2021-05-07,@Murray State,0,11,Murray State,-11
2021-05-08,@Murray State,4,6,Murray State,-2
2021-05-14,@Tennessee-Martin,9,8,Tennessee Tech,1
2021-05-15,@Tennessee-Martin,9,15,Tennessee Tech,-6
2021-05-15,@Tennessee-Martin,7,4,Tennessee Tech,3
2021-05-18,@Mississippi,9,7,Mississippi,2
2021-05-20,@Southeast Missouri State,2,6,Southeast Missouri State,-4
2021-05-21,@Southeast Missouri State,9,2,Southeast Missouri State,7
2021-05-21,@Southeast Missouri State,2,3,Southeast Missouri State,-1
2021-02-20,@Texas,3,8,Mississippi State,-5
2021-02-21,@Arkansas,0,4,Arkansas,-4
2021-02-22,@Texas,1,8,Mississippi,-7
2021-02-24,@Texas,3,1,Brigham Young,2
2021-02-25,@Texas,12,6,Brigham Young,6
2021-02-26,@Texas,11,1,Brigham Young,10
2021-02-27,@Texas,4,5,Brigham Young,-1
2021-03-02,@Texas,12,1,Texas A&M-Corpus Christi,11
2021-03-03,@Texas State,10,3,Texas State,7
2021-03-05,@Houston,1,0,Houston,1
2021-03-06,@Houston,2,3,Houston,-1
2021-03-07,@Houston,8,2,Houston,6
2021-03-09,@Texas,15,9,Sam Houston State,6
2021-03-12,@Texas,4,1,South Carolina,3
2021-03-13,@Texas,3,0,South Carolina,3
2021-03-14,@Texas,8,5,South Carolina,3
2021-03-16,@Texas,15,2,Texas-Rio Grande Valley,13
2021-03-19,@Baylor,5,3,Baylor,2
2021-03-20,@Baylor,4,3,Baylor,1
2021-03-21,@Baylor,2,11,Baylor,-9
2021-03-23,@Texas,10,1,Incarnate Word,9
2021-03-26,@Texas,4,3,Oklahoma,1
2021-03-27,@Texas,11,6,Oklahoma,5
2021-03-28,@Texas,2,3,Oklahoma,-1
2021-03-30,@Texas A&M,0,2,Texas A&M,-2
2021-04-01,@Kansas,5,2,Kansas,3
2021-04-02,@Kansas,7,0,Kansas,7
2021-04-03,@Kansas,11,2,Kansas,9
2021-04-06,@Texas,14,4,Texas A&M-Corpus Christi,10
2021-04-07,@Texas,9,1,Stephen F. Austin State,8
2021-04-09,@Texas,13,6,Kansas State,7
2021-04-10,@Texas,15,1,Kansas State,14
2021-04-11,@Texas,9,2,Kansas State,7
2021-04-13,@Texas,4,3,Nevada,1
2021-04-14,@Texas,6,5,Nevada,1
2021-04-16,@Texas,18,0,Abilene Christian,18
2021-04-17,@Texas,3,1,Abilene Christian,2
2021-04-18,@Texas,11,1,Abilene Christian,10
2021-04-20,@Texas State,5,1,Texas State,4
2021-04-24,@Oklahoma State,4,3,Oklahoma State,1
2021-04-24,@Oklahoma State,5,2,Oklahoma State,3
2021-04-25,@Oklahoma State,3,7,Oklahoma State,-4
2021-04-27,@Texas,5,3,Incarnate Word,2
2021-04-30,@Texas,3,6,Texas Tech,-3
2021-05-02,@Texas,3,5,Texas Tech,-2
2021-05-02,@Texas,11,3,Texas Tech,8
2021-05-04,@Texas,4,1,Texas State,3
2021-05-07,@Texas Christian,5,4,Texas Christian,1
2021-05-08,@Texas Christian,1,2,Texas Christian,-1
2021-05-09,@Texas Christian,9,3,Texas Christian,6
2021-05-20,@Texas,4,5,West Virginia,-1
2021-05-21,@Texas,14,3,West Virginia,11
2021-05-22,@Texas,12,2,West Virginia,10
2021-05-26,@Texas,1,5,West Virginia,-4
2021-05-27,@Texas,4,1,Oklahoma,3
2021-05-28,@Texas,3,2,West Virginia,1
2021-05-29,@Texas,4,5,Oklahoma State,-1
2021-06-04,@Texas,11,0,Southern,11
2021-06-05,@Texas,10,3,Arizona State,7
2021-06-06,@Fairfield,12,2,Fairfield,10
2021-06-12,@Texas,4,3,South Florida,1
2021-06-13,@South Florida,12,4,South Florida,8
2021-06-20,@Texas,1,2,Mississippi State,-1
2021-06-22,@Texas,8,4,Tennessee,4
2021-06-24,@Virginia,6,2,Virginia,4
2021-06-25,@Mississippi State,8,5,Mississippi State,3
2021-06-26,@Mississippi State,3,4,Mississippi State,-1
2021-02-20,@Texas A&M,0,2,Xavier,-2
2021-02-20,@Texas A&M,6,10,Xavier,-4
2021-02-21,@Texas A&M,15,0,Xavier,15
2021-02-23,@Texas A&M,5,6,Abilene Christian,-1
2021-02-24,@Texas A&M,8,7,Tarleton State,1
2021-02-26,@Baylor,12,4,Baylor,8
2021-02-27,@Texas A&M,8,1,Oklahoma,7
2021-02-28,@Texas A&M,1,6,Auburn,-5
2021-03-02,@Texas A&M,4,0,Houston Baptist,4
2021-03-03,@Texas A&M,6,4,Incarnate Word,2
2021-03-05,@Texas A&M,4,1,New Mexico State,3
2021-03-06,@Texas A&M,5,0,New Mexico State,5
2021-03-07,@Texas A&M,7,1,New Mexico State,6
2021-03-09,@Texas A&M,7,0,Texas A&M-Corpus Christi,7
2021-03-10,@Texas A&M,22,2,Prairie View A&M,20
2021-03-12,@Texas A&M,10,1,Samford,9
2021-03-13,@Texas A&M,21,4,Samford,17
2021-03-13,@Texas A&M,5,2,Samford,3
2021-03-16,@Houston,9,4,Houston,5
2021-03-18,@Florida,4,13,Florida,-9
2021-03-19,@Florida,1,3,Florida,-2
2021-03-20,@Florida,4,8,Florida,-4
2021-03-23,@Texas A&M,1,2,Rice,-1
2021-03-26,@Texas A&M,6,3,Georgia,3
2021-03-27,@Texas A&M,7,6,Georgia,1
2021-03-28,@Texas A&M,4,6,Georgia,-2
2021-03-30,@Texas A&M,2,0,Texas,2
2021-04-01,@Missouri,16,2,Missouri,14
2021-04-02,@Missouri,2,8,Missouri,-6
2021-04-03,@Missouri,3,7,Missouri,-4
2021-04-06,@Sam Houston State,6,8,Sam Houston State,-2
2021-04-09,@Texas A&M,3,5,Alabama,-2
2021-04-10,@Texas A&M,3,6,Alabama,-3
2021-04-11,@Texas A&M,4,7,Alabama,-3
2021-04-13,@Texas State,8,4,Texas State,4
2021-04-17,@Arkansas,1,2,Arkansas,-1
2021-04-17,@Arkansas,0,13,Arkansas,-13
2021-04-18,@Arkansas,11,10,Arkansas,1
2021-04-20,@Texas A&M,9,4,Texas Southern,5
2021-04-24,@Texas A&M,1,6,Tennessee,-5
2021-04-24,@Texas A&M,6,5,Tennessee,1
2021-04-25,@Texas A&M,7,20,Tennessee,-13
2021-04-27,@Texas A&M,4,0,Texas State,4
2021-04-30,@Mississippi State,7,8,Mississippi State,-1
2021-05-01,@Mississippi State,2,3,Mississippi State,-1
2021-05-01,@Mississippi State,5,10,Mississippi State,-5
2021-05-04,@Texas-Arlington,8,4,Texas-Arlington,4
2021-05-07,@Texas A&M,9,8,Mississippi,1
2021-05-08,@Texas A&M,7,12,Mississippi,-5
2021-05-09,@Texas A&M,6,5,Mississippi,1
2021-05-14,@Auburn,4,5,Auburn,-1
2021-05-15,@Auburn,11,9,Auburn,2
2021-05-16,@Auburn,5,8,Auburn,-3
2021-05-20,@Texas A&M,2,1,Louisiana State,1
2021-05-21,@Texas A&M,6,12,Louisiana State,-6
2021-05-22,@Texas A&M,2,8,Louisiana State,-6
2021-02-21,@Texas A&M-Corpus Christi,4,3,Central Michigan,1
2021-02-21,@Texas A&M-Corpus Christi,5,1,Central Michigan,4
2021-02-22,@Texas A&M-Corpus Christi,6,3,Central Michigan,3
2021-02-23,@Houston,8,12,Houston,-4
2021-02-26,@Texas A&M-Corpus Christi,3,2,Houston,1
2021-02-27,@Texas A&M-Corpus Christi,1,14,Houston,-13
2021-02-28,@Texas A&M-Corpus Christi,3,4,Houston,-1
2021-03-02,@Texas,1,12,Texas,-11
2021-03-05,@Texas Christian,5,15,Texas Christian,-10
2021-03-06,@Texas A&M-Corpus Christi,5,16,Rice,-11
2021-03-07,@Texas Tech,3,4,Texas Tech,-1
2021-03-09,@Texas A&M,0,7,Texas A&M,-7
2021-03-12,@McNeese State,2,4,McNeese State,-2
2021-03-13,@McNeese State,8,9,McNeese State,-1
2021-03-14,@McNeese State,7,12,McNeese State,-5
2021-03-19,@Texas A&M-Corpus Christi,5,11,Texas-San Antonio,-6
2021-03-20,@Texas A&M-Corpus Christi,4,7,Texas-San Antonio,-3
2021-03-21,@Texas A&M-Corpus Christi,1,10,Texas-San Antonio,-9
2021-03-26,@Sam Houston State,2,13,Sam Houston State,-11
2021-03-27,@Sam Houston State,12,6,Sam Houston State,6
2021-03-27,@Sam Houston State,4,9,Sam Houston State,-5
2021-03-28,@Sam Houston State,6,7,Sam Houston State,-1
2021-04-01,@Texas A&M-Corpus Christi,4,5,New Orleans,-1
2021-04-02,@Texas A&M-Corpus Christi,6,4,New Orleans,2
2021-04-02,@Texas A&M-Corpus Christi,6,7,New Orleans,-1
2021-04-03,@Texas A&M-Corpus Christi,4,6,New Orleans,-2
2021-04-06,@Texas,4,14,Texas,-10
2021-04-09,@Nicholls State,5,1,Nicholls State,4
2021-04-09,@Nicholls State,7,3,Nicholls State,4
2021-04-10,@Nicholls State,0,1,Nicholls State,-1
2021-04-11,@Nicholls State,12,2,Nicholls State,10
2021-04-16,@Texas A&M-Corpus Christi,7,4,Central Arkansas,3
2021-04-17,@Texas A&M-Corpus Christi,2,1,Central Arkansas,1
2021-04-18,@Texas A&M-Corpus Christi,5,1,Central Arkansas,4
2021-04-18,@Texas A&M-Corpus Christi,10,4,Central Arkansas,6
2021-04-20,@Texas-Rio Grande Valley,4,14,Texas-Rio Grande Valley,-10
2021-04-23,@Texas A&M-Corpus Christi,13,6,Houston Baptist,7
2021-04-24,@Texas A&M-Corpus Christi,4,0,Houston Baptist,4
2021-04-24,@Texas A&M-Corpus Christi,2,3,Houston Baptist,-1
2021-04-25,@Texas A&M-Corpus Christi,9,8,Houston Baptist,1
2021-04-30,@Lamar,6,0,Lamar,6
2021-04-30,@Lamar,11,7,Lamar,4
2021-05-01,@Lamar,3,7,Lamar,-4
2021-05-02,@Lamar,3,6,Lamar,-3
2021-05-07,@Texas A&M-Corpus Christi,5,1,Stephen F. Austin State,4
2021-05-08,@Texas A&M-Corpus Christi,10,2,Stephen F. Austin State,8
2021-05-08,@Texas A&M-Corpus Christi,5,2,Stephen F. Austin State,3
2021-05-09,@Texas A&M-Corpus Christi,3,5,Stephen F. Austin State,-2
2021-05-14,@Texas A&M-Corpus Christi,2,1,Southeastern Louisiana,1
2021-05-14,@Texas A&M-Corpus Christi,4,3,Southeastern Louisiana,1
2021-05-15,@Texas A&M-Corpus Christi,10,6,Southeastern Louisiana,4
2021-05-26,@Texas A&M-Corpus Christi,4,3,Sam Houston State,1
2021-05-27,@Abilene Christian,3,4,Abilene Christian,-1
2021-05-28,@Texas A&M-Corpus Christi,2,14,Sam Houston State,-12
2021-02-20,@Texas Christian,3,7,Mississippi,-4
2021-02-21,@Mississippi State,3,2,Mississippi State,1
2021-02-22,@Texas Christian,1,4,Arkansas,-3
2021-02-23,@Texas Christian,20,0,Texas Southern,20
2021-02-26,@Texas Christian,4,1,Liberty,3
2021-02-27,@Texas Christian,12,2,Liberty,10
2021-02-27,@Texas Christian,9,2,Liberty,7
2021-03-02,@Texas Christian,9,3,Stephen F. Austin State,6
2021-03-05,@Texas Christian,15,5,Texas A&M-Corpus Christi,10
2021-03-06,@Texas Christian,10,0,Texas State,10
2021-03-07,@Sam Houston State,5,6,Sam Houston State,-1
2021-03-09,@Texas State,1,11,Texas State,-10
2021-03-10,@Texas-San Antonio,6,3,Texas-San Antonio,3
2021-03-12,@Texas Christian,8,13,Gonzaga,-5
2021-03-13,@Texas Christian,7,1,Gonzaga,6
2021-03-14,@Texas Christian,7,10,Gonzaga,-3
2021-03-16,@Texas Christian,20,2,Arkansas-Pine Bluff,18
2021-03-19,@Louisiana-Lafayette,2,7,Louisiana-Lafayette,-5
2021-03-20,@Louisiana-Lafayette,13,4,Louisiana-Lafayette,9
2021-03-21,@Louisiana-Lafayette,5,1,Louisiana-Lafayette,4
2021-03-26,@Texas Christian,3,1,Baylor,2
2021-03-27,@Texas Christian,11,2,Baylor,9
2021-03-28,@Texas Christian,10,1,Baylor,9
2021-03-30,@Texas-Arlington,5,3,Texas-Arlington,2
2021-04-02,@Oklahoma,11,7,Oklahoma,4
2021-04-03,@Oklahoma,17,6,Oklahoma,11
2021-04-04,@Oklahoma,7,3,Oklahoma,4
2021-04-06,@Tarleton State,13,9,Tarleton State,4
2021-04-09,@Texas Tech,7,3,Texas Tech,4
2021-04-10,@Texas Tech,5,6,Texas Tech,-1
2021-04-11,@Texas Tech,7,17,Texas Tech,-10
2021-04-13,@Texas Christian,10,2,Tarleton State,8
2021-04-16,@Texas Christian,9,8,Oklahoma State,1
2021-04-17,@Texas Christian,8,7,Oklahoma State,1
2021-04-18,@Texas Christian,12,6,Oklahoma State,6
2021-04-20,@Texas Christian,9,1,Texas-Arlington,8
2021-04-23,@Texas Christian,15,1,Kansas,14
2021-04-24,@Texas Christian,10,3,Kansas,7
2021-04-25,@Texas Christian,1,2,Kansas,-1
2021-04-27,@Texas-Arlington,8,3,Texas-Arlington,5
2021-04-30,@West Virginia,8,2,West Virginia,6
2021-05-01,@West Virginia,5,3,West Virginia,2
2021-05-02,@West Virginia,9,1,West Virginia,8
2021-05-07,@Texas Christian,4,5,Texas,-1
2021-05-08,@Texas Christian,2,1,Texas,1
2021-05-09,@Texas Christian,3,9,Texas,-6
2021-05-14,@Texas Christian,3,4,Louisiana-Monroe,-1
2021-05-15,@Texas Christian,6,4,Louisiana-Monroe,2
2021-05-15,@Texas Christian,9,13,Louisiana-Monroe,-4
2021-05-20,@Kansas State,2,4,Kansas State,-2
2021-05-21,@Kansas State,8,6,Kansas State,2
2021-05-22,@Kansas State,8,11,Kansas State,-3
2021-05-26,@Texas Christian,7,6,Kansas State,1
2021-05-28,@Texas Christian,7,2,Texas Tech,5
2021-05-29,@Texas Christian,2,5,Kansas State,-3
2021-05-29,@Texas Christian,17,7,Kansas State,10
2021-05-30,@Texas Christian,10,7,Oklahoma State,3
2021-06-04,@Texas Christian,12,4,McNeese State,8
2021-06-05,@Dallas Baptist,6,8,Dallas Baptist,-2
2021-06-06,@Texas Christian,2,3,Oregon State,-1
2021-02-20,@Houston,4,10,Houston,-6
2021-02-20,@Houston,1,6,Houston,-5
2021-02-21,@Houston,4,14,Houston,-10
2021-02-23,@Texas Christian,0,20,Texas Christian,-20
2021-02-26,@Incarnate Word,1,12,Incarnate Word,-11
2021-02-27,@Incarnate Word,6,16,Incarnate Word,-10
2021-02-28,@Incarnate Word,5,13,Incarnate Word,-8
2021-03-02,@Texas Tech,2,14,Texas Tech,-12
2021-03-03,@Texas Tech,0,15,Texas Tech,-15
2021-03-05,@Texas Southern,3,2,Prairie View A&M,1
2021-03-06,@Texas Southern,9,3,Prairie View A&M,6
2021-03-07,@Texas Southern,7,2,Prairie View A&M,5
2021-03-09,@Louisiana State,4,10,Louisiana State,-6
2021-03-12,@Texas Southern,11,1,Arkansas-Pine Bluff,10
2021-03-13,@Texas Southern,10,14,Arkansas-Pine Bluff,-4
2021-03-13,@Texas Southern,3,14,Arkansas-Pine Bluff,-11
2021-03-16,@Tulane,6,12,Tulane,-6
2021-03-19,@Grambling State,4,5,Grambling State,-1
2021-03-20,@Grambling State,3,4,Grambling State,-1
2021-03-21,@Grambling State,13,14,Grambling State,-1
2021-03-23,@Texas Southern,10,8,Jarvis Christian,2
2021-04-01,@Texas Southern,7,2,Southern,5
2021-04-02,@Texas Southern,3,5,Southern,-2
2021-04-03,@Texas Southern,8,6,Southern,2
2021-04-06,@Kansas,1,8,Kansas,-7
2021-04-06,@Kansas,0,8,Kansas,-8
2021-04-09,@Prairie View A&M,6,4,Prairie View A&M,2
2021-04-10,@Prairie View A&M,2,4,Prairie View A&M,-2
2021-04-11,@Prairie View A&M,14,4,Prairie View A&M,10
2021-04-14,@Oklahoma,1,5,Oklahoma,-4
2021-04-14,@Oklahoma,0,6,Oklahoma,-6
2021-04-17,@Arkansas-Pine Bluff,11,2,Arkansas-Pine Bluff,9
2021-04-17,@Arkansas-Pine Bluff,2,3,Arkansas-Pine Bluff,-1
2021-04-18,@Arkansas-Pine Bluff,5,6,Arkansas-Pine Bluff,-1
2021-04-20,@Texas A&M,4,9,Texas A&M,-5
2021-04-24,@Texas Southern,1,10,Grambling State,-9
2021-04-25,@Texas Southern,8,16,Grambling State,-8
2021-04-26,@Texas Southern,7,10,Grambling State,-3
2021-04-30,@Kansas State,4,16,Kansas State,-12
2021-05-01,@Kansas State,6,15,Kansas State,-9
2021-05-02,@Kansas State,1,16,Kansas State,-15
2021-05-07,@Southern,5,7,Southern,-2
2021-05-08,@Southern,14,10,Southern,4
2021-05-09,@Southern,9,12,Southern,-3
2021-05-19,@Jackson State,4,7,Jackson State,-3
2021-05-20,@Alabama A&M,12,7,Alabama A&M,5
2021-05-21,@Grambling State,2,5,Grambling State,-3
2021-02-20,@Texas State,5,4,Brigham Young,1
2021-02-20,@Texas State,4,9,Brigham Young,-5
2021-02-22,@Texas State,11,6,Brigham Young,5
2021-02-23,@Texas State,6,7,Brigham Young,-1
2021-02-24,@Texas State,5,4,Sam Houston State,1
2021-02-27,@Sacramento State,4,8,Sacramento State,-4
2021-02-27,@Sacramento State,4,5,Sacramento State,-1
2021-02-28,@Sacramento State,1,7,Sacramento State,-6
2021-03-02,@Texas State,8,6,New Mexico State,2
2021-03-03,@Texas State,3,10,Texas,-7
2021-03-05,@Texas Tech,4,8,Texas Tech,-4
2021-03-06,@Texas Christian,0,10,Texas Christian,-10
2021-03-07,@Texas State,9,1,Rice,8
2021-03-09,@Texas State,11,1,Texas Christian,10
2021-03-12,@Texas State,3,12,Houston,-9
2021-03-13,@Texas State,15,9,Houston,6
2021-03-14,@Texas State,7,8,Houston,-1
2021-03-17,@Texas State,16,5,Rice,11
2021-03-19,@Arkansas-Little Rock,1,2,Arkansas-Little Rock,-1
2021-03-20,@Arkansas-Little Rock,0,12,Arkansas-Little Rock,-12
2021-03-21,@Arkansas-Little Rock,4,7,Arkansas-Little Rock,-3
2021-03-24,@Texas State,5,2,Oklahoma,3
2021-03-26,@Texas State,5,6,Louisiana-Monroe,-1
2021-03-27,@Texas State,6,5,Louisiana-Monroe,1
2021-03-28,@Texas State,4,1,Louisiana-Monroe,3
2021-03-30,@Baylor,2,4,Baylor,-2
2021-04-01,@Texas State,2,0,Texas-Arlington,2
2021-04-02,@Texas State,3,9,Texas-Arlington,-6
2021-04-03,@Texas State,6,10,Texas-Arlington,-4
2021-04-06,@Texas-Rio Grande Valley,7,4,Texas-Rio Grande Valley,3
2021-04-09,@Troy,4,2,Troy,2
2021-04-10,@Troy,3,1,Troy,2
2021-04-11,@Troy,3,5,Troy,-2
2021-04-13,@Texas State,4,8,Texas A&M,-4
2021-04-16,@Washington,5,10,Washington,-5
2021-04-17,@Washington,3,6,Washington,-3
2021-04-18,@Washington,1,2,Washington,-1
2021-04-20,@Texas State,1,5,Texas,-4
2021-04-23,@Texas State,11,4,Arkansas State,7
2021-04-24,@Texas State,6,5,Arkansas State,1
2021-04-25,@Texas State,1,12,Arkansas State,-11
2021-04-27,@Texas A&M,0,4,Texas A&M,-4
2021-04-30,@Louisiana-Lafayette,9,3,Louisiana-Lafayette,6
2021-05-01,@Louisiana-Lafayette,6,2,Louisiana-Lafayette,4
2021-05-01,@Louisiana-Lafayette,0,9,Louisiana-Lafayette,-9
2021-05-04,@Texas,1,4,Texas,-3
2021-05-07,@Texas State,6,3,South Alabama,3
2021-05-08,@Texas State,13,4,South Alabama,9
2021-05-09,@Texas State,4,9,South Alabama,-5
2021-05-14,@Texas State,4,7,Georgia State,-3
2021-05-14,@Texas State,4,9,Georgia State,-5
2021-05-15,@Texas State,5,7,Georgia State,-2
2021-05-20,@Coastal Carolina,5,10,Coastal Carolina,-5
2021-05-21,@Coastal Carolina,7,8,Coastal Carolina,-1
2021-05-22,@Coastal Carolina,2,12,Coastal Carolina,-10
2021-05-25,@Appalachian State,0,1,Appalachian State,-1
2021-05-26,@Texas State,6,12,Louisiana-Lafayette,-6
2021-02-20,@Texas Tech,9,13,Arkansas,-4
2021-02-21,@Mississippi,4,5,Mississippi,-1
2021-02-22,@Texas Tech,5,11,Mississippi State,-6
2021-02-26,@Texas Tech,18,3,Houston Baptist,15
2021-02-27,@Texas Tech,8,1,Houston Baptist,7
2021-02-28,@Texas Tech,11,2,Houston Baptist,9
2021-03-02,@Texas Tech,14,2,Texas Southern,12
2021-03-03,@Texas Tech,15,0,Texas Southern,15
2021-03-05,@Texas Tech,8,4,Texas State,4
2021-03-06,@Sam Houston State,8,0,Sam Houston State,8
2021-03-07,@Texas Tech,4,3,Texas A&M-Corpus Christi,1
2021-03-09,@Texas Tech,5,4,Gonzaga,1
2021-03-10,@Texas Tech,5,4,Gonzaga,1
2021-03-12,@Texas Tech,4,3,Connecticut,1
2021-03-13,@Texas Tech,10,3,Connecticut,7
2021-03-14,@Texas Tech,15,13,Connecticut,2
2021-03-15,@Texas Tech,9,8,Connecticut,1
2021-03-19,@Texas Tech,0,2,Oklahoma State,-2
2021-03-20,@Texas Tech,4,2,Oklahoma State,2
2021-03-21,@Texas Tech,6,5,Oklahoma State,1
2021-03-26,@Texas Tech,16,6,South Florida,10
2021-03-27,@Texas Tech,8,0,South Florida,8
2021-03-28,@Texas Tech,7,4,South Florida,3
2021-04-01,@Kansas State,17,1,Kansas State,16
2021-04-02,@Kansas State,2,7,Kansas State,-5
2021-04-03,@Kansas State,4,10,Kansas State,-6
2021-04-09,@Texas Tech,3,7,Texas Christian,-4
2021-04-10,@Texas Tech,6,5,Texas Christian,1
2021-04-11,@Texas Tech,17,7,Texas Christian,10
2021-04-13,@Texas Tech,4,3,Stephen F. Austin State,1
2021-04-14,@Texas Tech,7,5,Stephen F. Austin State,2
2021-04-16,@West Virginia,7,2,West Virginia,5
2021-04-17,@West Virginia,5,6,West Virginia,-1
2021-04-18,@West Virginia,10,1,West Virginia,9
2021-04-23,@Texas Tech,4,12,Baylor,-8
2021-04-24,@Texas Tech,4,1,Baylor,3
2021-04-25,@Texas Tech,3,13,Baylor,-10
2021-04-28,@Texas Tech,10,4,New Mexico,6
2021-04-30,@Texas,6,3,Texas,3
2021-05-02,@Texas,5,3,Texas,2
2021-05-02,@Texas,3,11,Texas,-8
2021-05-04,@Texas Tech,14,4,Oklahoma,10
2021-05-14,@Oklahoma,8,9,Oklahoma,-1
2021-05-15,@Oklahoma,15,2,Oklahoma,13
2021-05-16,@Oklahoma,13,2,Oklahoma,11
2021-05-20,@Texas Tech,4,7,Kansas,-3
2021-05-21,@Texas Tech,13,4,Kansas,9
2021-05-22,@Texas Tech,5,0,Kansas,5
2021-05-26,@Texas Tech,11,4,Baylor,7
2021-05-28,@Texas Christian,2,7,Texas Christian,-5
2021-05-28,@Texas Tech,2,7,Kansas State,-5
2021-06-04,@Texas Tech,6,3,Army,3
2021-06-05,@North Carolina,7,2,North Carolina,5
2021-06-06,@UCLA,8,2,UCLA,6
2021-06-11,@Texas Tech,3,15,Stanford,-12
2021-06-12,@Stanford,0,9,Stanford,-9
2021-02-23,@Texas-Arlington,14,1,Tarleton State,13
2021-02-24,@Texas-Arlington,1,7,Oklahoma,-6
2021-02-26,@Texas-Arlington,2,5,Stephen F. Austin State,-3
2021-02-27,@Texas-Arlington,5,3,Stephen F. Austin State,2
2021-02-27,@Texas-Arlington,2,1,Stephen F. Austin State,1
2021-03-02,@Texas-Arlington,3,2,Abilene Christian,1
2021-03-05,@Texas-San Antonio,1,13,Texas-San Antonio,-12
2021-03-06,@Texas-San Antonio,0,3,Texas-San Antonio,-3
2021-03-06,@Texas-San Antonio,2,1,Texas-San Antonio,1
2021-03-07,@Texas-San Antonio,1,16,Texas-San Antonio,-15
2021-03-09,@Oklahoma,5,15,Oklahoma,-10
2021-03-11,@Texas-Arlington,0,3,Lamar,-3
2021-03-12,@Texas-Arlington,0,2,Lamar,-2
2021-03-13,@Texas-Arlington,11,3,Lamar,8
2021-03-14,@Texas-Arlington,0,4,Lamar,-4
2021-03-19,@Texas-Arlington,3,2,South Alabama,1
2021-03-20,@Texas-Arlington,4,6,South Alabama,-2
2021-03-21,@Texas-Arlington,3,6,South Alabama,-3
2021-03-23,@Texas-Arlington,4,3,Baylor,1
2021-03-26,@Houston,1,4,Houston,-3
2021-03-27,@Houston,12,7,Houston,5
2021-03-27,@Houston,8,7,Houston,1
2021-03-28,@Houston,4,5,Houston,-1
2021-03-30,@Texas-Arlington,3,5,Texas Christian,-2
2021-04-01,@Texas State,0,2,Texas State,-2
2021-04-02,@Texas State,9,3,Texas State,6
2021-04-03,@Texas State,10,6,Texas State,4
2021-04-06,@Baylor,6,7,Baylor,-1
2021-04-10,@Texas-Arlington,7,8,Coastal Carolina,-1
2021-04-11,@Texas-Arlington,7,3,Coastal Carolina,4
2021-04-12,@Texas-Arlington,5,1,Coastal Carolina,4
2021-04-13,@Abilene Christian,10,11,Abilene Christian,-1
2021-04-16,@Arkansas State,7,5,Arkansas State,2
2021-04-17,@Arkansas State,9,2,Arkansas State,7
2021-04-18,@Arkansas State,3,5,Arkansas State,-2
2021-04-20,@Texas Christian,1,9,Texas Christian,-8
2021-04-21,@Texas-Arlington,8,1,Kansas,7
2021-04-24,@McNeese State,6,5,McNeese State,1
2021-04-24,@McNeese State,8,1,McNeese State,7
2021-04-25,@McNeese State,3,5,McNeese State,-2
2021-04-27,@Texas-Arlington,3,8,Texas Christian,-5
2021-05-01,@Texas-Arlington,1,0,Arkansas-Little Rock,1
2021-05-02,@Texas-Arlington,5,4,Arkansas-Little Rock,1
2021-05-02,@Texas-Arlington,3,0,Arkansas-Little Rock,3
2021-05-04,@Texas-Arlington,4,8,Texas A&M,-4
2021-05-07,@Louisiana-Monroe,6,1,Louisiana-Monroe,5
2021-05-08,@Louisiana-Monroe,8,10,Louisiana-Monroe,-2
2021-05-08,@Louisiana-Monroe,1,5,Louisiana-Monroe,-4
2021-05-14,@Texas-Arlington,3,4,Louisiana-Lafayette,-1
2021-05-15,@Texas-Arlington,6,2,Louisiana-Lafayette,4
2021-05-15,@Texas-Arlington,4,7,Louisiana-Lafayette,-3
2021-05-20,@Georgia Southern,5,3,Georgia Southern,2
2021-05-21,@Georgia Southern,2,3,Georgia Southern,-1
2021-05-22,@Georgia Southern,3,6,Georgia Southern,-3
2021-05-27,@Texas-Arlington,8,3,Arkansas State,5
2021-05-28,@Troy,11,5,Troy,6
2021-05-29,@South Alabama,4,5,South Alabama,-1
2021-02-21,@Texas-Rio Grande Valley,9,8,Baylor,1
2021-02-21,@Texas-Rio Grande Valley,7,12,Baylor,-5
2021-02-22,@Texas-Rio Grande Valley,7,4,Baylor,3
2021-02-27,@Washington,3,10,Washington,-7
2021-02-27,@Washington,2,3,Washington,-1
2021-02-28,@Washington,0,6,Washington,-6
2021-03-01,@Washington,2,0,Washington,2
2021-03-05,@Texas-Rio Grande Valley,11,1,Northern Illinois,10
2021-03-06,@Texas-Rio Grande Valley,15,2,Northern Illinois,13
2021-03-07,@Texas-Rio Grande Valley,4,3,Northern Illinois,1
2021-03-07,@Texas-Rio Grande Valley,5,4,Northern Illinois,1
2021-03-12,@Grand Canyon,6,2,Grand Canyon,4
2021-03-13,@Grand Canyon,9,4,Grand Canyon,5
2021-03-13,@Grand Canyon,4,8,Grand Canyon,-4
2021-03-14,@Grand Canyon,2,5,Grand Canyon,-3
2021-03-16,@Texas,2,15,Texas,-13
2021-03-19,@Dixie State,6,7,Dixie State,-1
2021-03-20,@Dixie State,18,1,Dixie State,17
2021-03-20,@Dixie State,13,3,Dixie State,10
2021-03-21,@Dixie State,2,3,Dixie State,-1
2021-03-25,@Dallas Baptist,2,10,Dallas Baptist,-8
2021-03-26,@Dallas Baptist,2,4,Dallas Baptist,-2
2021-03-27,@Dallas Baptist,5,6,Dallas Baptist,-1
2021-03-28,@Dallas Baptist,5,4,Dallas Baptist,1
2021-04-01,@Texas-Rio Grande Valley,0,3,California Baptist,-3
2021-04-02,@Texas-Rio Grande Valley,2,3,California Baptist,-1
2021-04-02,@Texas-Rio Grande Valley,2,3,California Baptist,-1
2021-04-03,@Texas-Rio Grande Valley,4,3,California Baptist,1
2021-04-06,@Texas-Rio Grande Valley,4,7,Texas State,-3
2021-04-09,@Texas-Rio Grande Valley,6,1,Utah Valley,5
2021-04-10,@Texas-Rio Grande Valley,5,6,Utah Valley,-1
2021-04-10,@Texas-Rio Grande Valley,5,4,Utah Valley,1
2021-04-11,@Texas-Rio Grande Valley,6,2,Utah Valley,4
2021-04-20,@Texas-Rio Grande Valley,14,4,Texas A&M-Corpus Christi,10
2021-04-23,@Texas-Rio Grande Valley,11,4,Seattle,7
2021-04-24,@Texas-Rio Grande Valley,13,0,Seattle,13
2021-04-24,@Texas-Rio Grande Valley,5,4,Seattle,1
2021-04-25,@Texas-Rio Grande Valley,6,5,Seattle,1
2021-04-30,@New Mexico State,8,5,New Mexico State,3
2021-05-01,@New Mexico State,8,12,New Mexico State,-4
2021-05-01,@New Mexico State,1,12,New Mexico State,-11
2021-05-02,@New Mexico State,10,11,New Mexico State,-1
2021-05-07,@Texas-Rio Grande Valley,3,2,Tarleton State,1
2021-05-08,@Texas-Rio Grande Valley,9,7,Tarleton State,2
2021-05-08,@Texas-Rio Grande Valley,6,7,Tarleton State,-1
2021-05-09,@Texas-Rio Grande Valley,11,1,Tarleton State,10
2021-05-14,@Texas-Rio Grande Valley,5,0,Northern Colorado,5
2021-05-14,@Texas-Rio Grande Valley,10,0,Northern Colorado,10
2021-05-16,@Texas-Rio Grande Valley,15,2,Northern Colorado,13
2021-05-20,@Sacramento State,4,5,Sacramento State,-1
2021-05-21,@Sacramento State,5,20,Sacramento State,-15
2021-05-21,@Sacramento State,5,6,Sacramento State,-1
2021-05-22,@Sacramento State,4,2,Sacramento State,2
2021-05-26,@Texas-Rio Grande Valley,5,4,Utah Valley,1
2021-05-27,@Sacramento State,5,9,Sacramento State,-4
2021-05-28,@Seattle,19,9,Seattle,10
2021-05-29,@Texas-Rio Grande Valley,10,0,Sacramento State,10
2021-05-29,@Texas-Rio Grande Valley,4,5,Grand Canyon,-1
2021-02-26,@Sam Houston State,2,4,Sam Houston State,-2
2021-02-27,@Sam Houston State,10,4,Sam Houston State,6
2021-02-28,@Sam Houston State,18,5,Sam Houston State,13
2021-03-05,@Texas-San Antonio,13,1,Texas-Arlington,12
2021-03-06,@Texas-San Antonio,1,2,Texas-Arlington,-1
2021-03-06,@Texas-San Antonio,3,0,Texas-Arlington,3
2021-03-07,@Texas-San Antonio,16,1,Texas-Arlington,15
2021-03-10,@Texas-San Antonio,3,6,Texas Christian,-3
2021-03-12,@Louisiana State,1,3,Louisiana State,-2
2021-03-13,@Louisiana State,9,10,Louisiana State,-1
2021-03-14,@Louisiana State,12,13,Louisiana State,-1
2021-03-16,@Baylor,8,10,Baylor,-2
2021-03-19,@Texas A&M-Corpus Christi,11,5,Texas A&M-Corpus Christi,6
2021-03-20,@Texas A&M-Corpus Christi,7,4,Texas A&M-Corpus Christi,3
2021-03-21,@Texas A&M-Corpus Christi,10,1,Texas A&M-Corpus Christi,9
2021-03-26,@Rice,16,4,Rice,12
2021-03-27,@Rice,8,10,Rice,-2
2021-03-27,@Rice,4,1,Rice,3
2021-03-28,@Rice,11,3,Rice,8
2021-04-01,@Texas-San Antonio,1,9,Southern Mississippi,-8
2021-04-02,@Texas-San Antonio,9,13,Southern Mississippi,-4
2021-04-02,@Texas-San Antonio,5,11,Southern Mississippi,-6
2021-04-09,@Texas-San Antonio,7,6,Middle Tennessee State,1
2021-04-10,@Texas-San Antonio,3,5,Middle Tennessee State,-2
2021-04-10,@Texas-San Antonio,3,2,Middle Tennessee State,1
2021-04-11,@Texas-San Antonio,15,1,Middle Tennessee State,14
2021-04-16,@North Carolina-Charlotte,2,6,North Carolina-Charlotte,-4
2021-04-17,@North Carolina-Charlotte,10,11,North Carolina-Charlotte,-1
2021-04-17,@North Carolina-Charlotte,6,10,North Carolina-Charlotte,-4
2021-04-18,@North Carolina-Charlotte,11,5,North Carolina-Charlotte,6
2021-04-23,@Texas-San Antonio,6,8,Rice,-2
2021-04-24,@Texas-San Antonio,12,6,Rice,6
2021-04-24,@Texas-San Antonio,4,5,Rice,-1
2021-04-25,@Texas-San Antonio,12,4,Rice,8
2021-04-30,@Alabama-Birmingham,2,4,Alabama-Birmingham,-2
2021-05-01,@Alabama-Birmingham,14,3,Alabama-Birmingham,11
2021-05-01,@Alabama-Birmingham,4,6,Alabama-Birmingham,-2
2021-05-02,@Alabama-Birmingham,16,14,Alabama-Birmingham,2
2021-05-07,@Texas-San Antonio,11,14,Old Dominion,-3
2021-05-08,@Texas-San Antonio,12,10,Old Dominion,2
2021-05-08,@Texas-San Antonio,11,0,Old Dominion,11
2021-05-09,@Texas-San Antonio,2,6,Old Dominion,-4
2021-05-14,@Louisiana Tech,7,5,Louisiana Tech,2
2021-05-15,@Louisiana Tech,7,10,Louisiana Tech,-3
2021-05-15,@Louisiana Tech,1,4,Louisiana Tech,-3
2021-05-16,@Louisiana Tech,7,17,Louisiana Tech,-10
2021-05-26,@Louisiana Tech,6,7,Louisiana Tech,-1
2021-05-27,@Western Kentucky,9,10,Western Kentucky,-1
2021-02-19,@The Citadel,5,12,Longwood,-7
2021-02-20,@The Citadel,2,4,Longwood,-2
2021-02-21,@The Citadel,9,6,Longwood,3
2021-02-26,@The Citadel,8,4,North Florida,4
2021-02-27,@The Citadel,6,13,North Florida,-7
2021-02-27,@The Citadel,2,3,North Florida,-1
2021-03-03,@Jacksonville,7,6,Jacksonville,1
2021-03-05,@The Citadel,6,7,North Carolina A&T,-1
2021-03-06,@The Citadel,7,6,North Carolina A&T,1
2021-03-07,@The Citadel,1,12,North Carolina A&T,-11
2021-03-10,@The Citadel,7,11,South Carolina,-4
2021-03-12,@The Citadel,2,0,Davidson,2
2021-03-13,@The Citadel,19,0,Davidson,19
2021-03-14,@The Citadel,8,4,Davidson,4
2021-03-19,@The Citadel,5,3,Wofford,2
2021-03-19,@The Citadel,4,5,Wofford,-1
2021-03-20,@The Citadel,0,6,Wofford,-6
2021-03-23,@South Carolina,3,8,South Carolina,-5
2021-03-26,@Western Carolina,6,11,Western Carolina,-5
2021-03-26,@Western Carolina,8,12,Western Carolina,-4
2021-04-02,@The Citadel,2,12,Mercer,-10
2021-04-03,@The Citadel,5,6,Mercer,-1
2021-04-03,@The Citadel,2,12,Mercer,-10
2021-04-06,@College of Charleston,4,5,College of Charleston,-1
2021-04-10,@Samford,11,12,Samford,-1
2021-04-10,@Samford,1,14,Samford,-13
2021-04-11,@Samford,4,8,Samford,-4
2021-04-14,@The Citadel,3,2,Jacksonville,1
2021-04-16,@The Citadel,5,4,East Tennessee State,1
2021-04-17,@The Citadel,6,4,East Tennessee State,2
2021-04-17,@The Citadel,2,7,East Tennessee State,-5
2021-04-20,@The Citadel,2,11,College of Charleston,-9
2021-04-23,@North Carolina-Greensboro,2,4,North Carolina-Greensboro,-2
2021-04-23,@North Carolina-Greensboro,7,9,North Carolina-Greensboro,-2
2021-04-24,@North Carolina-Greensboro,1,14,North Carolina-Greensboro,-13
2021-04-27,@South Carolina,5,9,South Carolina,-4
2021-04-30,@The Citadel,5,13,VMI,-8
2021-05-01,@The Citadel,4,5,VMI,-1
2021-05-01,@The Citadel,5,9,VMI,-4
2021-05-05,@The Citadel,2,10,Mississippi State,-8
2021-05-07,@Wofford,2,11,Wofford,-9
2021-05-09,@Wofford,10,11,Wofford,-1
2021-05-09,@Wofford,0,9,Wofford,-9
2021-05-11,@The Citadel,3,6,College of Charleston,-3
2021-05-14,@Mercer,1,5,Mercer,-4
2021-05-15,@Mercer,8,7,Mercer,1
2021-05-15,@Mercer,5,8,Mercer,-3
2021-05-18,@College of Charleston,3,10,College of Charleston,-7
2021-05-20,@The Citadel,1,2,Western Carolina,-1
2021-05-21,@The Citadel,0,21,Western Carolina,-21
2021-05-21,@The Citadel,3,6,Western Carolina,-3
2021-02-19,@South Carolina-Upstate,2,14,South Carolina-Upstate,-12
2021-02-20,@South Carolina-Upstate,1,5,South Carolina-Upstate,-4
2021-02-21,@South Carolina-Upstate,6,7,South Carolina-Upstate,-1
2021-02-27,@Davidson,1,8,Davidson,-7
2021-02-27,@Davidson,2,12,Davidson,-10
2021-02-28,@Davidson,14,16,Davidson,-2
2021-03-05,@Samford,4,9,Samford,-5
2021-03-06,@Samford,14,3,Samford,11
2021-03-07,@Samford,8,16,Samford,-8
2021-03-12,@Wofford,3,13,Wofford,-10
2021-03-13,@Wofford,6,11,Wofford,-5
2021-03-13,@Wofford,1,2,Wofford,-1
2021-03-14,@Wofford,9,6,Wofford,3
2021-03-19,"@Miami, Ohio",6,9,"Miami, Ohio",-3
2021-03-20,"@Miami, Ohio",1,2,"Miami, Ohio",-1
2021-03-20,"@Miami, Ohio",4,3,"Miami, Ohio",1
2021-03-21,"@Miami, Ohio",2,5,"Miami, Ohio",-3
2021-03-26,@Ball State,6,7,Ball State,-1
2021-03-27,@Ball State,6,3,Ball State,3
2021-03-27,@Ball State,1,7,Ball State,-6
2021-03-28,@Ball State,7,8,Ball State,-1
2021-04-02,@Toledo,2,13,Ohio,-11
2021-04-03,@Toledo,6,11,Ohio,-5
2021-04-03,@Toledo,6,5,Ohio,1
2021-04-04,@Toledo,7,6,Ohio,1
2021-04-09,@Kent State,8,7,Kent State,1
2021-04-10,@Kent State,9,8,Kent State,1
2021-04-10,@Kent State,8,9,Kent State,-1
2021-04-11,@Kent State,15,14,Kent State,1
2021-04-16,@Toledo,6,1,Akron,5
2021-04-17,@Toledo,12,4,Akron,8
2021-04-17,@Toledo,7,0,Akron,7
2021-04-18,@Toledo,12,2,Akron,10
2021-04-30,@Toledo,13,16,Western Michigan,-3
2021-05-01,@Toledo,11,10,Western Michigan,1
2021-05-01,@Toledo,6,15,Western Michigan,-9
2021-05-02,@Toledo,16,9,Western Michigan,7
2021-05-04,@Eastern Michigan,2,13,Eastern Michigan,-11
2021-05-08,@Virginia Tech,1,7,Virginia Tech,-6
2021-05-08,@Virginia Tech,2,3,Virginia Tech,-1
2021-05-09,@Virginia Tech,5,16,Virginia Tech,-11
2021-05-11,@Eastern Michigan,10,2,Eastern Michigan,8
2021-05-11,@Eastern Michigan,0,6,Eastern Michigan,-6
2021-05-14,@Toledo,5,2,Bowling Green State,3
2021-05-15,@Toledo,4,5,Bowling Green State,-1
2021-05-15,@Toledo,12,5,Bowling Green State,7
2021-05-16,@Toledo,19,2,Bowling Green State,17
2021-05-18,@Eastern Michigan,16,10,Eastern Michigan,6
2021-05-21,@Northern Illinois,7,3,Northern Illinois,4
2021-05-22,@Northern Illinois,5,8,Northern Illinois,-3
2021-05-22,@Northern Illinois,9,1,Northern Illinois,8
2021-05-23,@Northern Illinois,4,1,Northern Illinois,3
2021-05-29,@Toledo,0,1,Central Michigan,-1
2021-05-29,@Toledo,0,9,Central Michigan,-9
2021-05-30,@Toledo,1,10,Central Michigan,-9
2021-05-30,@Toledo,4,5,Central Michigan,-1
2021-02-19,@Western Carolina,1,23,Western Carolina,-22
2021-02-20,@Western Carolina,3,4,Western Carolina,-1
2021-02-20,@Western Carolina,5,15,Western Carolina,-10
2021-02-21,@Western Carolina,1,5,Western Carolina,-4
2021-02-27,@Winthrop,7,2,Winthrop,5
2021-02-27,@Winthrop,3,7,Winthrop,-4
2021-02-28,@Winthrop,4,5,Winthrop,-1
2021-03-05,@Georgia Southern,1,5,Georgia Southern,-4
2021-03-06,@Georgia Southern,5,7,Georgia Southern,-2
2021-03-07,@Georgia Southern,5,6,Georgia Southern,-1
2021-03-10,@Towson,3,12,St. Joseph's,-9
2021-03-12,@Virginia Commonwealth,9,14,Virginia Commonwealth,-5
2021-03-13,@Virginia Commonwealth,8,7,Virginia Commonwealth,1
2021-03-14,@Virginia Commonwealth,1,5,Virginia Commonwealth,-4
2021-03-17,@Virginia,0,5,Virginia,-5
2021-03-20,@Towson,4,0,Massachusetts,4
2021-03-20,@Towson,8,7,Massachusetts,1
2021-03-21,@Towson,1,3,Massachusetts,-2
2021-03-21,@Towson,1,10,Massachusetts,-9
2021-03-26,@Towson,3,2,George Mason,1
2021-03-27,@George Mason,9,10,George Mason,-1
2021-03-27,@George Mason,5,1,George Mason,4
2021-03-28,@Towson,6,5,George Mason,1
2021-04-02,@Towson,0,12,Delaware,-12
2021-04-03,@Towson,7,6,Delaware,1
2021-04-03,@Towson,10,2,Delaware,8
2021-04-04,@Towson,8,3,Delaware,5
2021-04-07,@Towson,4,13,Navy,-9
2021-04-10,@Richmond,3,11,Richmond,-8
2021-04-10,@Richmond,9,10,Richmond,-1
2021-04-11,@Towson,6,14,Richmond,-8
2021-04-13,@Georgetown,4,0,Georgetown,4
2021-04-17,@Towson,5,3,Fordham,2
2021-04-17,@Towson,3,2,Fordham,1
2021-04-21,@George Washington,4,8,George Washington,-4
2021-04-23,@Hofstra,9,8,Hofstra,1
2021-04-23,@Hofstra,4,3,Hofstra,1
2021-04-24,@Hofstra,2,5,Hofstra,-3
2021-04-24,@Hofstra,7,8,Hofstra,-1
2021-04-27,@Towson,11,16,LaSalle,-5
2021-04-30,@Northeastern,0,3,Northeastern,-3
2021-05-01,@Northeastern,4,7,Northeastern,-3
2021-05-01,@Northeastern,1,2,Northeastern,-1
2021-05-02,@Northeastern,1,3,Northeastern,-2
2021-05-07,@Delaware,6,5,Delaware,1
2021-05-08,@Delaware,12,4,Delaware,8
2021-05-08,@Delaware,12,7,Delaware,5
2021-05-09,@Delaware,3,9,Delaware,-6
2021-05-14,@Towson,4,2,Hofstra,2
2021-05-15,@Towson,4,6,Hofstra,-2
2021-05-15,@Towson,8,5,Hofstra,3
2021-05-16,@Towson,5,8,Hofstra,-3
2021-05-20,@Towson,2,15,Northeastern,-13
2021-05-21,@Towson,2,1,Northeastern,1
2021-05-22,@Towson,0,5,Northeastern,-5
2021-05-26,@College of Charleston,5,6,College of Charleston,-1
2021-05-27,@Towson,3,7,William and Mary,-4
2021-02-19,@Troy,10,4,Youngstown State,6
2021-02-20,@Troy,13,6,Youngstown State,7
2021-02-20,@Troy,8,2,Youngstown State,6
2021-02-21,@Troy,2,4,Youngstown State,-2
2021-02-23,@Troy,10,3,Alabama-Birmingham,7
2021-02-26,@Troy,6,3,Jacksonville,3
2021-02-27,@Troy,8,1,Jacksonville,7
2021-02-28,@Troy,9,0,Jacksonville,9
2021-03-03,@Alabama,1,9,Alabama,-8
2021-03-05,@Southeastern Louisiana,2,7,Southeastern Louisiana,-5
2021-03-06,@Southeastern Louisiana,1,7,Southeastern Louisiana,-6
2021-03-07,@Southeastern Louisiana,2,4,Southeastern Louisiana,-2
2021-03-09,@Troy,5,6,Samford,-1
2021-03-12,@Troy,4,9,Tulane,-5
2021-03-13,@Troy,12,3,Tulane,9
2021-03-14,@Troy,2,14,Tulane,-12
2021-03-19,@Troy,1,8,Georgia Southern,-7
2021-03-20,@Troy,11,8,Georgia Southern,3
2021-03-21,@Troy,8,4,Georgia Southern,4
2021-03-24,@Alabama State,16,3,Alabama State,13
2021-03-26,@Troy,3,6,Central Florida,-3
2021-03-27,@Troy,2,1,Central Florida,1
2021-03-28,@Troy,14,12,Central Florida,2
2021-04-01,@South Alabama,0,6,South Alabama,-6
2021-04-02,@South Alabama,3,6,South Alabama,-3
2021-04-03,@South Alabama,0,8,South Alabama,-8
2021-04-06,@Samford,3,4,Samford,-1
2021-04-09,@Troy,2,4,Texas State,-2
2021-04-10,@Troy,1,3,Texas State,-2
2021-04-11,@Troy,5,3,Texas State,2
2021-04-13,@Alabama-Birmingham,12,4,Alabama-Birmingham,8
2021-04-16,@Georgia State,4,0,Georgia State,4
2021-04-17,@Georgia State,5,7,Georgia State,-2
2021-04-18,@Georgia State,15,17,Georgia State,-2
2021-04-20,@Jacksonville State,1,6,Jacksonville State,-5
2021-04-23,@Troy,2,0,Appalachian State,2
2021-04-25,@Troy,9,4,Appalachian State,5
2021-04-25,@Troy,12,2,Appalachian State,10
2021-04-27,@Troy,2,0,Jacksonville State,2
2021-04-30,@Florida State,2,3,Florida State,-1
2021-05-01,@Florida State,3,0,Florida State,3
2021-05-02,@Florida State,2,4,Florida State,-2
2021-05-07,@Coastal Carolina,9,7,Coastal Carolina,2
2021-05-08,@Coastal Carolina,9,7,Coastal Carolina,2
2021-05-09,@Coastal Carolina,10,6,Coastal Carolina,4
2021-05-14,@Troy,12,4,Arkansas State,8
2021-05-15,@Troy,3,1,Arkansas State,2
2021-05-16,@Troy,5,9,Arkansas State,-4
2021-05-20,@Louisiana-Lafayette,6,5,Louisiana-Lafayette,1
2021-05-21,@Louisiana-Lafayette,2,3,Louisiana-Lafayette,-1
2021-05-22,@Louisiana-Lafayette,1,2,Louisiana-Lafayette,-1
2021-05-25,@Troy,6,9,Arkansas State,-3
2021-05-28,@Troy,5,11,Texas-Arlington,-6
2021-02-19,@Tulane,3,2,Louisiana-Lafayette,1
2021-02-20,@Tulane,8,9,Louisiana-Lafayette,-1
2021-02-21,@Tulane,7,9,Louisiana-Lafayette,-2
2021-02-23,@Tulane,7,1,New Orleans,6
2021-02-26,@Mississippi State,7,3,Mississippi State,4
2021-02-27,@Mississippi State,5,9,Mississippi State,-4
2021-02-28,@Mississippi State,4,5,Mississippi State,-1
2021-03-03,@Southeastern Louisiana,1,6,Southeastern Louisiana,-5
2021-03-05,@Tulane,6,5,Western Kentucky,1
2021-03-06,@Tulane,5,2,Western Kentucky,3
2021-03-07,@Tulane,7,8,Western Kentucky,-1
2021-03-09,@Tulane,6,0,Southern,6
2021-03-12,@Troy,9,4,Troy,5
2021-03-13,@Troy,3,12,Troy,-9
2021-03-14,@Troy,14,2,Troy,12
2021-03-16,@Tulane,12,6,Texas Southern,6
2021-03-19,@Tulane,0,2,Louisiana Tech,-2
2021-03-20,@Tulane,0,4,Louisiana Tech,-4
2021-03-21,@Tulane,6,8,Louisiana Tech,-2
2021-03-26,@Tulane,7,4,Grand Canyon,3
2021-03-27,@Tulane,7,8,Grand Canyon,-1
2021-03-28,@Tulane,0,6,Grand Canyon,-6
2021-03-30,@Tulane,10,7,Jackson State,3
2021-04-01,@Tulane,3,4,Memphis,-1
2021-04-02,@Tulane,7,1,Memphis,6
2021-04-02,@Tulane,11,2,Memphis,9
2021-04-03,@Tulane,8,2,Memphis,6
2021-04-16,@Tulane,3,2,Wichita State,1
2021-04-16,@Tulane,6,3,Wichita State,3
2021-04-18,@Tulane,8,7,Wichita State,1
2021-04-23,@Memphis,4,2,Memphis,2
2021-04-23,@Memphis,13,2,Memphis,11
2021-04-24,@Memphis,5,0,Memphis,5
2021-04-25,@Memphis,12,3,Memphis,9
2021-04-30,@Tulane,3,0,Houston,3
2021-04-30,@Tulane,11,4,Houston,7
2021-05-01,@Tulane,6,5,Houston,1
2021-05-01,@Tulane,4,7,Houston,-3
2021-05-07,@East Carolina,4,12,East Carolina,-8
2021-05-08,@East Carolina,4,7,East Carolina,-3
2021-05-08,@East Carolina,7,6,East Carolina,1
2021-05-09,@East Carolina,1,9,East Carolina,-8
2021-05-14,@Tulane,9,1,Central Florida,8
2021-05-14,@Tulane,5,4,Central Florida,1
2021-05-15,@Tulane,4,6,Central Florida,-2
2021-05-16,@Tulane,14,7,Central Florida,7
2021-05-20,@Cincinnati,6,10,Cincinnati,-4
2021-05-20,@Cincinnati,8,11,Cincinnati,-3
2021-05-21,@Cincinnati,1,11,Cincinnati,-10
2021-05-22,@Cincinnati,12,13,Cincinnati,-1
2021-05-25,@Tulane,4,1,Houston,3
2021-05-27,@Tulane,0,5,South Florida,-5
2021-05-28,@Tulane,12,2,Wichita State,10
2021-05-29,@Tulane,16,6,South Florida,10
2021-05-29,@Tulane,1,7,South Florida,-6
2021-02-19,@UC Davis,1,11,Washington State,-10
2021-02-20,@UC Davis,5,12,Washington State,-7
2021-02-21,@UC Davis,13,5,Washington State,8
2021-02-21,@UC Davis,3,5,Washington State,-2
2021-02-28,@UC Davis,1,0,Portland,1
2021-02-28,@UC Davis,4,7,Portland,-3
2021-03-01,@UC Davis,8,1,Portland,7
2021-03-05,@UC Davis,1,6,California Baptist,-5
2021-03-06,@UC Davis,4,5,California Baptist,-1
2021-03-07,@UC Davis,5,6,California Baptist,-1
2021-03-12,@UC Davis,10,5,Pepperdine,5
2021-03-13,@UC Davis,0,15,Pepperdine,-15
2021-03-13,@UC Davis,5,3,Pepperdine,2
2021-03-14,@UC Davis,2,5,Pepperdine,-3
2021-03-19,@UC Davis,1,10,UC Irvine,-9
2021-03-20,@UC Davis,0,8,UC Irvine,-8
2021-03-20,@UC Davis,2,6,UC Irvine,-4
2021-03-21,@UC Davis,4,5,UC Irvine,-1
2021-03-26,@UC Santa Barbara,5,6,UC Santa Barbara,-1
2021-03-27,@UC Santa Barbara,3,7,UC Santa Barbara,-4
2021-03-27,@UC Santa Barbara,0,12,UC Santa Barbara,-12
2021-03-28,@UC Santa Barbara,4,5,UC Santa Barbara,-1
2021-04-02,@UC Davis,1,5,UC Riverside,-4
2021-04-03,@UC Davis,2,6,UC Riverside,-4
2021-04-03,@UC Davis,6,4,UC Riverside,2
2021-04-04,@UC Davis,9,0,UC Riverside,9
2021-04-09,@CSU Bakersfield,5,0,CSU Bakersfield,5
2021-04-10,@CSU Bakersfield,9,7,CSU Bakersfield,2
2021-04-10,@CSU Bakersfield,4,14,CSU Bakersfield,-10
2021-04-11,@CSU Bakersfield,2,5,CSU Bakersfield,-3
2021-04-16,@UC Davis,3,9,Cal State Fullerton,-6
2021-04-17,@UC Davis,1,2,Cal State Fullerton,-1
2021-04-17,@UC Davis,9,7,Cal State Fullerton,2
2021-04-18,@UC Davis,6,7,Cal State Fullerton,-1
2021-04-23,@Hawaii,2,6,Hawaii,-4
2021-04-24,@Hawaii,2,7,Hawaii,-5
2021-04-24,@Hawaii,3,8,Hawaii,-5
2021-04-25,@Hawaii,2,9,Hawaii,-7
2021-05-01,@UC Davis,12,2,San Jose State,10
2021-05-01,@UC Davis,3,4,San Jose State,-1
2021-05-02,@UC Davis,11,14,San Jose State,-3
2021-05-07,@UC Davis,6,10,Cal State Northridge,-4
2021-05-08,@UC Davis,13,9,Cal State Northridge,4
2021-05-08,@UC Davis,5,11,Cal State Northridge,-6
2021-05-09,@UC Davis,3,8,Cal State Northridge,-5
2021-05-14,@UC San Diego,5,2,UC San Diego,3
2021-05-15,@UC San Diego,3,18,UC San Diego,-15
2021-05-15,@UC San Diego,3,8,UC San Diego,-5
2021-05-16,@UC San Diego,4,6,UC San Diego,-2
2021-05-21,@UC Davis,5,2,Cal Poly,3
2021-05-22,@UC Davis,2,3,Cal Poly,-1
2021-05-22,@UC Davis,1,5,Cal Poly,-4
2021-05-23,@UC Davis,2,6,Cal Poly,-4
2021-05-28,@Long Beach State,0,7,Long Beach State,-7
2021-05-29,@Long Beach State,4,7,Long Beach State,-3
2021-05-29,@Long Beach State,1,7,Long Beach State,-6
2021-05-30,@Long Beach State,4,10,Long Beach State,-6
2021-02-20,@UC Irvine,5,4,Washington,1
2021-02-21,@UC Irvine,5,4,Washington,1
2021-02-22,@UC Irvine,3,1,Washington,2
2021-02-26,@UCLA,3,4,UCLA,-1
2021-02-27,@UC Irvine,7,3,UCLA,4
2021-02-28,@UCLA,0,4,UCLA,-4
2021-03-06,@UC Riverside,5,6,UC Riverside,-1
2021-03-07,@UC Riverside,8,10,UC Riverside,-2
2021-03-07,@UC Riverside,14,12,UC Riverside,2
2021-03-12,@Stanford,1,4,Stanford,-3
2021-03-13,@Stanford,5,1,Stanford,4
2021-03-13,@Stanford,1,6,Stanford,-5
2021-03-14,@Stanford,6,8,Stanford,-2
2021-03-19,@UC Davis,10,1,UC Davis,9
2021-03-20,@UC Davis,8,0,UC Davis,8
2021-03-20,@UC Davis,6,2,UC Davis,4
2021-03-21,@UC Davis,5,4,UC Davis,1
2021-03-26,@UC Irvine,4,0,Hawaii,4
2021-03-27,@UC Irvine,4,3,Hawaii,1
2021-03-27,@UC Irvine,12,5,Hawaii,7
2021-03-28,@UC Irvine,20,10,Hawaii,10
2021-04-03,@Cal State Northridge,17,3,Cal State Northridge,14
2021-04-03,@Cal State Northridge,7,8,Cal State Northridge,-1
2021-04-04,@Cal State Northridge,20,3,Cal State Northridge,17
2021-04-04,@Cal State Northridge,6,9,Cal State Northridge,-3
2021-04-09,@UC Irvine,4,0,UC San Diego,4
2021-04-10,@UC Irvine,9,3,UC San Diego,6
2021-04-10,@UC Irvine,11,1,UC San Diego,10
2021-04-11,@UC Irvine,2,5,UC San Diego,-3
2021-04-16,@Cal Poly,11,6,Cal Poly,5
2021-04-17,@Cal Poly,4,1,Cal Poly,3
2021-04-17,@Cal Poly,3,4,Cal Poly,-1
2021-04-18,@Cal Poly,17,1,Cal Poly,16
2021-04-23,@UC Irvine,5,7,Oregon State,-2
2021-04-24,@UC Irvine,11,9,Oregon State,2
2021-04-25,@UC Irvine,7,6,Oregon State,1
2021-04-30,@UC Irvine,12,5,Long Beach State,7
2021-05-01,@UC Irvine,4,13,Long Beach State,-9
2021-05-01,@UC Irvine,3,2,Long Beach State,1
2021-05-02,@UC Irvine,0,9,Long Beach State,-9
2021-05-07,@UC Santa Barbara,5,6,UC Santa Barbara,-1
2021-05-08,@UC Santa Barbara,6,0,UC Santa Barbara,6
2021-05-08,@UC Santa Barbara,5,1,UC Santa Barbara,4
2021-05-09,@UC Santa Barbara,7,2,UC Santa Barbara,5
2021-05-14,@UC Irvine,9,8,UC Riverside,1
2021-05-15,@UC Irvine,5,2,UC Riverside,3
2021-05-15,@UC Irvine,8,1,UC Riverside,7
2021-05-16,@UC Irvine,9,1,UC Riverside,8
2021-05-21,@CSU Bakersfield,11,5,CSU Bakersfield,6
2021-05-22,@CSU Bakersfield,2,1,CSU Bakersfield,1
2021-05-22,@CSU Bakersfield,9,11,CSU Bakersfield,-2
2021-05-23,@CSU Bakersfield,7,4,CSU Bakersfield,3
2021-05-28,@UC Irvine,10,4,Cal State Fullerton,6
2021-05-29,@UC Irvine,9,5,Cal State Fullerton,4
2021-05-29,@UC Irvine,7,0,Cal State Fullerton,7
2021-05-30,@UC Irvine,4,2,Cal State Fullerton,2
2021-06-04,@UC Irvine,7,0,Nevada,7
2021-06-05,@Stanford,4,12,Stanford,-8
2021-06-06,@North Dakota State,18,3,North Dakota State,15
2021-06-06,@UC Irvine,8,4,Stanford,4
2021-06-07,@UC Irvine,8,11,Stanford,-3
2021-03-06,@UC Riverside,6,5,UC Irvine,1
2021-03-07,@UC Riverside,10,8,UC Irvine,2
2021-03-07,@UC Riverside,12,14,UC Irvine,-2
2021-03-12,@San Diego,4,16,San Diego,-12
2021-03-13,@San Diego,0,9,San Diego,-9
2021-03-13,@San Diego,0,7,San Diego,-7
2021-03-14,@San Diego,4,5,San Diego,-1
2021-03-19,@CSU Bakersfield,9,15,CSU Bakersfield,-6
2021-03-20,@CSU Bakersfield,5,4,CSU Bakersfield,1
2021-03-20,@CSU Bakersfield,1,7,CSU Bakersfield,-6
2021-03-21,@CSU Bakersfield,7,9,CSU Bakersfield,-2
2021-03-26,@UC Riverside,3,4,Cal State Fullerton,-1
2021-03-27,@UC Riverside,7,5,Cal State Fullerton,2
2021-03-27,@UC Riverside,6,18,Cal State Fullerton,-12
2021-03-28,@UC Riverside,8,16,Cal State Fullerton,-8
2021-04-02,@UC Davis,5,1,UC Davis,4
2021-04-03,@UC Davis,6,2,UC Davis,4
2021-04-03,@UC Davis,4,6,UC Davis,-2
2021-04-04,@UC Davis,0,9,UC Davis,-9
2021-04-09,@UC Riverside,5,7,Hawaii,-2
2021-04-10,@UC Riverside,4,13,Hawaii,-9
2021-04-10,@UC Riverside,0,7,Hawaii,-7
2021-04-11,@UC Riverside,9,2,Hawaii,7
2021-04-16,@Cal State Northridge,6,5,Cal State Northridge,1
2021-04-17,@Cal State Northridge,8,4,Cal State Northridge,4
2021-04-17,@Cal State Northridge,5,1,Cal State Northridge,4
2021-04-18,@Cal State Northridge,8,15,Cal State Northridge,-7
2021-04-23,@Cal Poly,2,4,Cal Poly,-2
2021-04-24,@Cal Poly,9,6,Cal Poly,3
2021-04-24,@Cal Poly,2,8,Cal Poly,-6
2021-04-25,@Cal Poly,6,3,Cal Poly,3
2021-04-30,@UC Riverside,1,20,UC San Diego,-19
2021-05-01,@UC Riverside,13,3,UC San Diego,10
2021-05-01,@UC Riverside,11,6,UC San Diego,5
2021-05-02,@UC Riverside,2,8,UC San Diego,-6
2021-05-07,@UC Riverside,0,4,Long Beach State,-4
2021-05-08,@UC Riverside,4,10,Long Beach State,-6
2021-05-08,@UC Riverside,0,13,Long Beach State,-13
2021-05-09,@UC Riverside,7,8,Long Beach State,-1
2021-05-14,@UC Irvine,8,9,UC Irvine,-1
2021-05-15,@UC Irvine,2,5,UC Irvine,-3
2021-05-15,@UC Irvine,1,8,UC Irvine,-7
2021-05-16,@UC Irvine,1,9,UC Irvine,-8
2021-05-21,@UC Riverside,3,7,UC Santa Barbara,-4
2021-05-22,@UC Riverside,0,12,UC Santa Barbara,-12
2021-05-22,@UC Riverside,3,14,UC Santa Barbara,-11
2021-05-23,@UC Riverside,6,10,UC Santa Barbara,-4
2021-05-27,@UC Riverside,4,5,California Baptist,-1
2021-05-28,@California Baptist,4,7,California Baptist,-3
2021-05-28,@California Baptist,12,6,California Baptist,6
2021-05-29,@UC Riverside,6,14,California Baptist,-8
2021-02-19,@UC Santa Barbara,4,8,Santa Clara,-4
2021-02-20,@UC Santa Barbara,9,6,Santa Clara,3
2021-02-21,@UC Santa Barbara,5,4,Santa Clara,1
2021-02-26,@Pepperdine,7,6,Pepperdine,1
2021-02-27,@UC Santa Barbara,5,0,Pepperdine,5
2021-02-27,@UC Santa Barbara,9,7,Pepperdine,2
2021-02-28,@Pepperdine,12,2,Pepperdine,10
2021-03-05,@UC Santa Barbara,6,7,Oregon,-1
2021-03-06,@UC Santa Barbara,2,17,Oregon,-15
2021-03-06,@UC Santa Barbara,4,5,Oregon,-1
2021-03-07,@UC Santa Barbara,4,9,Oregon,-5
2021-03-13,@UC Santa Barbara,15,3,San Francisco,12
2021-03-13,@UC Santa Barbara,9,8,San Francisco,1
2021-03-14,@UC Santa Barbara,6,2,San Francisco,4
2021-03-19,@Cal State Fullerton,9,2,Cal State Fullerton,7
2021-03-20,@Cal State Fullerton,11,4,Cal State Fullerton,7
2021-03-20,@Cal State Fullerton,1,4,Cal State Fullerton,-3
2021-03-21,@Cal State Fullerton,9,10,Cal State Fullerton,-1
2021-03-26,@UC Santa Barbara,6,5,UC Davis,1
2021-03-27,@UC Santa Barbara,12,0,UC Davis,12
2021-03-27,@UC Santa Barbara,7,3,UC Davis,4
2021-03-28,@UC Santa Barbara,5,4,UC Davis,1
2021-04-02,@Hawaii,3,0,Hawaii,3
2021-04-03,@Hawaii,5,4,Hawaii,1
2021-04-03,@Hawaii,5,6,Hawaii,-1
2021-04-04,@Hawaii,9,1,Hawaii,8
2021-04-09,@UC Santa Barbara,5,4,Cal State Northridge,1
2021-04-10,@UC Santa Barbara,11,3,Cal State Northridge,8
2021-04-10,@UC Santa Barbara,11,1,Cal State Northridge,10
2021-04-11,@UC Santa Barbara,3,7,Cal State Northridge,-4
2021-04-16,@UC San Diego,15,2,UC San Diego,13
2021-04-17,@UC San Diego,15,10,UC San Diego,5
2021-04-17,@UC San Diego,15,5,UC San Diego,10
2021-04-18,@UC San Diego,5,9,UC San Diego,-4
2021-04-23,@Long Beach State,3,4,Long Beach State,-1
2021-04-24,@Long Beach State,4,5,Long Beach State,-1
2021-04-24,@Long Beach State,6,0,Long Beach State,6
2021-04-25,@Long Beach State,8,5,Long Beach State,3
2021-04-30,@UC Santa Barbara,4,1,Cal Poly,3
2021-05-01,@UC Santa Barbara,1,5,Cal Poly,-4
2021-05-01,@UC Santa Barbara,2,1,Cal Poly,1
2021-05-02,@UC Santa Barbara,12,3,Cal Poly,9
2021-05-07,@UC Santa Barbara,6,5,UC Irvine,1
2021-05-08,@UC Santa Barbara,1,5,UC Irvine,-4
2021-05-08,@UC Santa Barbara,0,6,UC Irvine,-6
2021-05-09,@UC Santa Barbara,2,7,UC Irvine,-5
2021-05-14,@UCLA,10,4,UCLA,6
2021-05-15,@UC Santa Barbara,2,5,UCLA,-3
2021-05-16,@UCLA,3,11,UCLA,-8
2021-05-21,@UC Riverside,7,3,UC Riverside,4
2021-05-22,@UC Riverside,14,3,UC Riverside,11
2021-05-22,@UC Riverside,12,0,UC Riverside,12
2021-05-23,@UC Riverside,10,6,UC Riverside,4
2021-05-28,@UC Santa Barbara,5,2,CSU Bakersfield,3
2021-05-29,@UC Santa Barbara,6,0,CSU Bakersfield,6
2021-05-29,@UC Santa Barbara,13,3,CSU Bakersfield,10
2021-05-30,@UC Santa Barbara,11,5,CSU Bakersfield,6
2021-06-04,@Oklahoma State,14,4,Oklahoma State,10
2021-06-05,@UC Santa Barbara,0,4,Arizona,-4
2021-06-06,@UC Santa Barbara,13,3,Oklahoma State,10
2021-06-06,@Arizona,2,5,Arizona,-3
2021-02-19,@UCLA,2,6,San Francisco,-4
2021-02-20,@UCLA,8,2,San Francisco,6
2021-02-21,@UCLA,3,8,San Francisco,-5
2021-02-23,@UCLA,5,2,Loyola Marymount,3
2021-02-26,@UCLA,4,3,UC Irvine,1
2021-02-27,@UC Irvine,3,7,UC Irvine,-4
2021-02-28,@UCLA,4,0,UC Irvine,4
2021-03-02,@UCLA,14,1,Cal State Fullerton,13
2021-03-05,@UCLA,16,8,Pepperdine,8
2021-03-06,@UCLA,6,1,Cal State Fullerton,5
2021-03-07,@UCLA,10,1,Southern California,9
2021-03-09,@Cal State Fullerton,6,2,Cal State Fullerton,4
2021-03-12,@Cal Poly,4,5,Cal Poly,-1
2021-03-13,@Cal Poly,13,12,Cal Poly,1
2021-03-14,@Cal Poly,5,8,Cal Poly,-3
2021-03-19,@UCLA,3,2,Arizona,1
2021-03-20,@UCLA,3,7,Arizona,-4
2021-03-21,@UCLA,11,3,Arizona,8
2021-03-23,@UCLA,13,6,Loyola Marymount,7
2021-03-26,@Southern California,4,5,Southern California,-1
2021-03-27,@Southern California,6,3,Southern California,3
2021-03-28,@Southern California,13,1,Southern California,12
2021-04-01,@UCLA,6,8,Washington,-2
2021-04-02,@UCLA,6,7,Washington,-1
2021-04-03,@UCLA,13,2,Washington,11
2021-04-09,@Stanford,2,6,Stanford,-4
2021-04-10,@Stanford,6,11,Stanford,-5
2021-04-11,@Stanford,6,1,Stanford,5
2021-04-13,@UCLA,12,2,Loyola Marymount,10
2021-04-16,@UCLA,20,0,Utah,20
2021-04-17,@UCLA,13,3,Utah,10
2021-04-18,@UCLA,9,2,Utah,7
2021-04-20,@Pepperdine,5,4,Pepperdine,1
2021-04-23,@Oregon,3,5,Oregon,-2
2021-04-24,@Oregon,2,3,Oregon,-1
2021-04-25,@Oregon,7,6,Oregon,1
2021-04-30,@UCLA,6,5,Oregon State,1
2021-05-01,@UCLA,2,0,Oregon State,2
2021-05-02,@UCLA,3,5,Oregon State,-2
2021-05-07,@Washington State,2,5,Washington State,-3
2021-05-08,@Washington State,7,6,Washington State,1
2021-05-09,@Washington State,16,7,Washington State,9
2021-05-11,@Loyola Marymount,9,8,Loyola Marymount,1
2021-05-14,@UCLA,4,10,UC Santa Barbara,-6
2021-05-15,@UC Santa Barbara,5,2,UC Santa Barbara,3
2021-05-16,@UCLA,11,3,UC Santa Barbara,8
2021-05-18,@UCLA,11,3,Nevada,8
2021-05-21,@UCLA,2,14,California,-12
2021-05-22,@UCLA,2,4,California,-2
2021-05-23,@UCLA,7,4,California,3
2021-05-27,@Arizona State,21,9,Arizona State,12
2021-05-28,@Arizona State,8,5,Arizona State,3
2021-05-29,@Arizona State,3,0,Arizona State,3
2021-06-04,@UCLA,4,5,North Carolina,-1
2021-06-05,@Army,13,6,Army,7
2021-06-06,@North Carolina,12,2,North Carolina,10
2021-06-06,@UCLA,2,8,Texas Tech,-6
2021-02-20,@Cal State Fullerton,1,3,Cal State Fullerton,-2
2021-02-21,@Cal State Fullerton,1,15,Cal State Fullerton,-14
2021-02-22,@Cal State Fullerton,6,5,Cal State Fullerton,1
2021-02-26,@Loyola Marymount,6,7,Loyola Marymount,-1
2021-02-27,@Loyola Marymount,7,9,Loyola Marymount,-2
2021-02-28,@Loyola Marymount,1,4,Loyola Marymount,-3
2021-03-05,@Arizona State,3,4,Arizona State,-1
2021-03-06,@Arizona State,1,4,Arizona State,-3
2021-03-07,@Arizona State,0,5,Arizona State,-5
2021-03-11,@Utah,6,3,Brigham Young,3
2021-03-12,@Utah,7,1,Brigham Young,6
2021-03-19,@Stanford,2,4,Stanford,-2
2021-03-20,@Stanford,8,4,Stanford,4
2021-03-21,@Stanford,1,4,Stanford,-3
2021-03-23,@Utah,7,9,Dixie State,-2
2021-03-26,@Utah,0,9,California,-9
2021-03-27,@Utah,5,9,California,-4
2021-03-28,@Utah,11,4,California,7
2021-04-01,@Oregon State,3,4,Oregon State,-1
2021-04-02,@Oregon State,3,17,Oregon State,-14
2021-04-03,@Oregon State,5,3,Oregon State,2
2021-04-06,@Dixie State,16,3,Dixie State,13
2021-04-09,@Utah,7,12,Washington State,-5
2021-04-10,@Utah,10,7,Washington State,3
2021-04-11,@Utah,3,5,Washington State,-2
2021-04-13,@Brigham Young,4,7,Brigham Young,-3
2021-04-16,@UCLA,0,20,UCLA,-20
2021-04-17,@UCLA,3,13,UCLA,-10
2021-04-18,@UCLA,2,9,UCLA,-7
2021-04-20,@Utah Valley,14,1,Utah Valley,13
2021-04-23,@Utah,4,5,Arizona State,-1
2021-04-24,@Utah,6,10,Arizona State,-4
2021-04-25,@Utah,7,6,Arizona State,1
2021-04-30,@Arizona,1,11,Arizona,-10
2021-05-01,@Arizona,3,4,Arizona,-1
2021-05-02,@Arizona,3,15,Arizona,-12
2021-05-08,@Utah,8,5,Northern Colorado,3
2021-05-09,@Utah,11,7,Northern Colorado,4
2021-05-10,@Utah,12,3,Northern Colorado,9
2021-05-12,@Utah,10,9,Utah Valley,1
2021-05-14,@Utah,3,7,Oregon,-4
2021-05-15,@Utah,3,16,Oregon,-13
2021-05-16,@Utah,2,9,Oregon,-7
2021-05-18,@Brigham Young,11,5,Brigham Young,6
2021-05-21,@Washington,7,3,Washington,4
2021-05-22,@Washington,1,2,Washington,-1
2021-05-23,@Washington,5,6,Washington,-1
2021-05-27,@Utah,3,7,Southern California,-4
2021-05-28,@Utah,2,1,Southern California,1
2021-05-29,@Utah,11,17,Southern California,-6
2021-02-19,@St. Mary's,2,1,St. Mary's,1
2021-02-20,@St. Mary's,3,2,St. Mary's,1
2021-02-20,@St. Mary's,2,5,St. Mary's,-3
2021-02-21,@St. Mary's,0,2,St. Mary's,-2
2021-03-05,@Cal Poly,3,17,Cal Poly,-14
2021-03-06,@Cal Poly,1,5,Cal Poly,-4
2021-03-07,@Cal Poly,0,6,Cal Poly,-6
2021-03-12,@Portland,6,10,Portland,-4
2021-03-13,@Portland,5,6,Portland,-1
2021-03-13,@Portland,0,3,Portland,-3
2021-03-14,@Portland,1,5,Portland,-4
2021-03-19,@Utah Valley,5,8,Sacramento State,-3
2021-03-19,@Utah Valley,3,8,Sacramento State,-5
2021-03-21,@Utah Valley,7,11,Sacramento State,-4
2021-03-21,@Utah Valley,4,10,Sacramento State,-6
2021-03-23,@Brigham Young,7,11,Brigham Young,-4
2021-03-26,@Northern Colorado,0,10,Northern Colorado,-10
2021-03-27,@Northern Colorado,7,3,Northern Colorado,4
2021-03-27,@Northern Colorado,1,8,Northern Colorado,-7
2021-03-28,@Northern Colorado,7,6,Northern Colorado,1
2021-04-01,@Utah Valley,2,8,Grand Canyon,-6
2021-04-02,@Utah Valley,1,4,Grand Canyon,-3
2021-04-02,@Utah Valley,4,3,Grand Canyon,1
2021-04-03,@Utah Valley,2,7,Grand Canyon,-5
2021-04-07,@Utah Valley,3,5,Washington State,-2
2021-04-09,@Texas-Rio Grande Valley,1,6,Texas-Rio Grande Valley,-5
2021-04-10,@Texas-Rio Grande Valley,6,5,Texas-Rio Grande Valley,1
2021-04-10,@Texas-Rio Grande Valley,4,5,Texas-Rio Grande Valley,-1
2021-04-11,@Texas-Rio Grande Valley,2,6,Texas-Rio Grande Valley,-4
2021-04-16,@Utah Valley,3,4,Tarleton State,-1
2021-04-17,@Utah Valley,1,8,Tarleton State,-7
2021-04-17,@Utah Valley,7,9,Tarleton State,-2
2021-04-18,@Utah Valley,8,4,Tarleton State,4
2021-04-20,@Utah Valley,1,14,Utah,-13
2021-04-23,@California Baptist,0,10,California Baptist,-10
2021-04-24,@California Baptist,3,7,California Baptist,-4
2021-04-24,@California Baptist,7,11,California Baptist,-4
2021-04-25,@California Baptist,2,6,California Baptist,-4
2021-04-30,@Dixie State,8,9,Dixie State,-1
2021-05-01,@Dixie State,9,10,Dixie State,-1
2021-05-01,@Dixie State,2,4,Dixie State,-2
2021-05-02,@Dixie State,0,11,Dixie State,-11
2021-05-04,@Utah Valley,4,11,Brigham Young,-7
2021-05-07,@Utah Valley,3,6,New Mexico State,-3
2021-05-08,@Utah Valley,7,10,New Mexico State,-3
2021-05-08,@Utah Valley,4,2,New Mexico State,2
2021-05-09,@Utah Valley,7,5,New Mexico State,2
2021-05-12,@Utah,9,10,Utah,-1
2021-05-14,@New Mexico,4,9,New Mexico,-5
2021-05-15,@New Mexico,2,16,New Mexico,-14
2021-05-16,@New Mexico,6,14,New Mexico,-8
2021-05-20,@Seattle,2,7,Seattle,-5
2021-05-21,@Seattle,3,5,Seattle,-2
2021-05-21,@Seattle,2,7,Seattle,-5
2021-05-22,@Seattle,14,5,Seattle,9
2021-05-26,@Texas-Rio Grande Valley,4,5,Texas-Rio Grande Valley,-1
2021-05-27,@Seattle,8,9,Seattle,-1
2021-02-23,@Virginia,5,14,Virginia,-9
2021-02-25,@VMI,2,1,New Jersey Tech,1
2021-02-25,@VMI,5,16,New Jersey Tech,-11
2021-02-26,@VMI,8,7,New Jersey Tech,1
2021-03-02,@Virginia Commonwealth,8,10,Virginia Commonwealth,-2
2021-03-05,@VMI,2,17,Virginia Commonwealth,-15
2021-03-06,@Richmond,3,10,Richmond,-7
2021-03-07,@VMI,7,18,Virginia Commonwealth,-11
2021-03-11,@James Madison,5,9,James Madison,-4
2021-03-13,@VMI,17,7,James Madison,10
2021-03-14,@VMI,7,12,James Madison,-5
2021-03-16,@VMI,3,12,Radford,-9
2021-03-17,@George Washington,8,1,George Washington,7
2021-03-19,@East Tennessee State,0,4,East Tennessee State,-4
2021-03-20,@East Tennessee State,6,3,East Tennessee State,3
2021-03-20,@East Tennessee State,2,7,East Tennessee State,-5
2021-03-23,@VMI,4,8,Richmond,-4
2021-03-26,@VMI,6,5,North Carolina-Greensboro,1
2021-03-27,@VMI,2,13,North Carolina-Greensboro,-11
2021-03-27,@VMI,3,11,North Carolina-Greensboro,-8
2021-04-02,@Samford,4,11,Samford,-7
2021-04-02,@Samford,6,7,Samford,-1
2021-04-03,@Samford,6,7,Samford,-1
2021-04-10,@Western Carolina,0,3,Western Carolina,-3
2021-04-11,@Western Carolina,12,16,Western Carolina,-4
2021-04-11,@Western Carolina,8,9,Western Carolina,-1
2021-04-16,@VMI,4,3,Mercer,1
2021-04-17,@VMI,5,4,Mercer,1
2021-04-17,@VMI,10,0,Mercer,10
2021-04-20,@Virginia Tech,5,7,Virginia Tech,-2
2021-04-23,@VMI,11,7,Wofford,4
2021-04-23,@VMI,1,7,Wofford,-6
2021-04-24,@VMI,2,3,Wofford,-1
2021-04-27,@Virginia Commonwealth,5,15,Virginia Commonwealth,-10
2021-04-30,@The Citadel,13,5,The Citadel,8
2021-05-01,@The Citadel,9,5,The Citadel,4
2021-05-01,@The Citadel,5,4,The Citadel,1
2021-05-07,@VMI,1,25,Samford,-24
2021-05-07,@VMI,5,11,Samford,-6
2021-05-08,@VMI,1,18,Samford,-17
2021-05-11,@VMI,9,5,Norfolk State,4
2021-05-14,@VMI,6,5,East Tennessee State,1
2021-05-15,@VMI,6,9,East Tennessee State,-3
2021-05-15,@VMI,3,1,East Tennessee State,2
2021-05-20,@North Carolina-Greensboro,5,7,North Carolina-Greensboro,-2
2021-05-21,@North Carolina-Greensboro,3,2,North Carolina-Greensboro,1
2021-05-21,@North Carolina-Greensboro,8,4,North Carolina-Greensboro,4
2021-02-19,@Alabama-Birmingham,6,2,Alabama-Birmingham,4
2021-02-20,@Alabama-Birmingham,2,8,Alabama-Birmingham,-6
2021-02-21,@Alabama-Birmingham,1,4,Alabama-Birmingham,-3
2021-02-26,@Jacksonville State,4,5,Jacksonville State,-1
2021-02-27,@Jacksonville State,3,13,Jacksonville State,-10
2021-02-27,@Jacksonville State,2,10,Jacksonville State,-8
2021-03-12,@Middle Tennessee State,2,5,Middle Tennessee State,-3
2021-03-13,@Middle Tennessee State,3,2,Middle Tennessee State,1
2021-03-13,@Middle Tennessee State,5,0,Middle Tennessee State,5
2021-03-14,@Middle Tennessee State,0,5,Middle Tennessee State,-5
2021-03-19,@Western Kentucky,4,8,Western Kentucky,-4
2021-03-20,@Western Kentucky,8,6,Western Kentucky,2
2021-03-21,@Western Kentucky,1,11,Western Kentucky,-10
2021-03-23,@Notre Dame,3,6,Notre Dame,-3
2021-03-26,@Butler,4,5,Butler,-1
2021-03-27,@Butler,10,13,Butler,-3
2021-03-27,@Butler,7,1,Butler,6
2021-04-01,@Dallas Baptist,1,6,Dallas Baptist,-5
2021-04-02,@Dallas Baptist,8,9,Dallas Baptist,-1
2021-04-02,@Dallas Baptist,4,8,Dallas Baptist,-4
2021-04-03,@Dallas Baptist,2,5,Dallas Baptist,-3
2021-04-16,@Indiana State,0,5,Indiana State,-5
2021-04-17,@Indiana State,2,6,Indiana State,-4
2021-04-17,@Indiana State,2,11,Indiana State,-9
2021-04-18,@Indiana State,1,12,Indiana State,-11
2021-04-23,@Valparaiso,7,6,Southern Illinois,1
2021-04-23,@Valparaiso,4,3,Southern Illinois,1
2021-04-24,@Valparaiso,4,10,Southern Illinois,-6
2021-04-25,@Valparaiso,4,2,Southern Illinois,2
2021-04-27,@Notre Dame,7,8,Notre Dame,-1
2021-04-30,@Valparaiso,3,2,Illinois State,1
2021-05-01,@Valparaiso,3,12,Illinois State,-9
2021-05-01,@Valparaiso,17,13,Illinois State,4
2021-05-02,@Valparaiso,7,6,Illinois State,1
2021-05-07,@Bradley,2,1,Bradley,1
2021-05-07,@Bradley,5,9,Bradley,-4
2021-05-08,@Bradley,10,3,Bradley,7
2021-05-08,@Bradley,2,3,Bradley,-1
2021-05-11,@Valparaiso,4,7,Notre Dame,-3
2021-05-14,@Valparaiso,6,13,Evansville,-7
2021-05-15,@Valparaiso,9,12,Evansville,-3
2021-05-15,@Valparaiso,5,1,Evansville,4
2021-05-16,@Valparaiso,9,11,Evansville,-2
2021-05-20,@Missouri State,1,2,Missouri State,-1
2021-05-21,@Missouri State,4,9,Missouri State,-5
2021-05-21,@Missouri State,6,7,Missouri State,-1
2021-05-22,@Missouri State,1,2,Missouri State,-1
2021-05-25,@Missouri State,6,4,Missouri State,2
2021-05-26,@Dallas Baptist,2,12,Dallas Baptist,-10
2021-05-27,@Illinois State,6,5,Illinois State,1
2021-05-28,@Valparaiso,5,11,Southern Illinois,-6
2021-02-22,@Vanderbilt,14,1,Wright State,13
2021-02-22,@Vanderbilt,1,0,Wright State,1
2021-02-24,@Vanderbilt,12,1,Western Kentucky,11
2021-02-26,@Vanderbilt,2,4,Georgia State,-2
2021-02-27,@Vanderbilt,5,4,Georgia State,1
2021-02-28,@Vanderbilt,12,2,Georgia State,10
2021-02-28,@Vanderbilt,17,6,Georgia State,11
2021-03-05,@Vanderbilt,15,0,Illinois-Chicago,15
2021-03-06,@Vanderbilt,5,2,Illinois-Chicago,3
2021-03-07,@Vanderbilt,4,2,Illinois-Chicago,2
2021-03-09,@Vanderbilt,10,4,Memphis,6
2021-03-13,@Oklahoma State,18,4,Oklahoma State,14
2021-03-13,@Oklahoma State,5,0,Oklahoma State,5
2021-03-14,@Oklahoma State,6,10,Oklahoma State,-4
2021-03-16,@Vanderbilt,4,1,Belmont,3
2021-03-19,@Vanderbilt,3,2,South Carolina,1
2021-03-20,@Vanderbilt,5,0,South Carolina,5
2021-03-21,@Vanderbilt,5,6,South Carolina,-1
2021-03-23,@Vanderbilt,11,3,Lipscomb,8
2021-03-25,@Missouri,10,2,Missouri,8
2021-03-26,@Missouri,11,3,Missouri,8
2021-03-27,@Missouri,3,1,Missouri,2
2021-03-30,@Vanderbilt,12,5,Tennessee Tech,7
2021-04-01,@Louisiana State,13,1,Louisiana State,12
2021-04-02,@Louisiana State,11,2,Louisiana State,9
2021-04-03,@Louisiana State,5,4,Louisiana State,1
2021-04-06,@Vanderbilt,5,4,Tennessee-Martin,1
2021-04-08,@Vanderbilt,2,14,Georgia,-12
2021-04-09,@Vanderbilt,5,2,Georgia,3
2021-04-10,@Vanderbilt,1,9,Georgia,-8
2021-04-13,@Vanderbilt,6,4,Eastern Kentucky,2
2021-04-16,@Tennessee,5,0,Tennessee,5
2021-04-17,@Tennessee,4,8,Tennessee,-4
2021-04-18,@Tennessee,10,4,Tennessee,6
2021-04-20,@Vanderbilt,7,0,Austin Peay State,7
2021-04-23,@Vanderbilt,6,2,Mississippi State,4
2021-04-24,@Vanderbilt,4,7,Mississippi State,-3
2021-04-25,@Vanderbilt,7,4,Mississippi State,3
2021-04-30,@Florida,11,7,Florida,4
2021-05-01,@Florida,8,11,Florida,-3
2021-05-02,@Florida,3,5,Florida,-2
2021-05-04,@Louisville,2,7,Louisville,-5
2021-05-07,@Vanderbilt,9,6,Alabama,3
2021-05-08,@Vanderbilt,6,2,Alabama,4
2021-05-11,@Vanderbilt,3,2,North Alabama,1
2021-05-14,@Mississippi,1,3,Mississippi,-2
2021-05-15,@Mississippi,13,2,Mississippi,11
2021-05-16,@Mississippi,10,13,Mississippi,-3
2021-05-18,@Vanderbilt,20,4,Florida International,16
2021-05-20,@Vanderbilt,4,2,Kentucky,2
2021-05-21,@Vanderbilt,8,2,Kentucky,6
2021-05-22,@Vanderbilt,5,7,Kentucky,-2
2021-05-26,@Vanderbilt,5,4,Mississippi,1
2021-05-27,@Arkansas,4,6,Arkansas,-2
2021-05-28,@Vanderbilt,1,4,Mississippi,-3
2021-06-04,@Vanderbilt,10,0,Presbyterian,10
2021-06-05,@Vanderbilt,4,3,Georgia Tech,1
2021-06-06,@Georgia Tech,14,11,Georgia Tech,3
2021-06-11,@Vanderbilt,2,0,East Carolina,2
2021-06-12,@East Carolina,4,1,East Carolina,3
2021-06-19,@Vanderbilt,7,6,Arizona,1
2021-06-21,@North Carolina State,0,1,North Carolina State,-1
2021-06-23,@Vanderbilt,6,5,Stanford,1
2021-06-25,@North Carolina State,3,1,North Carolina State,2
2021-06-28,@Vanderbilt,8,2,Mississippi State,6
2021-06-29,@Mississippi State,2,13,Mississippi State,-11
2021-06-30,@Vanderbilt,0,9,Mississippi State,-9
2021-02-27,@Radford,3,5,Radford,-2
2021-02-28,@Radford,1,6,Radford,-5
2021-03-07,@Villanova,3,1,Hofstra,2
2021-03-07,@Villanova,5,0,Hofstra,5
2021-03-13,@Villanova,6,5,Delaware,1
2021-03-14,@Delaware,11,10,Delaware,1
2021-03-20,@Stony Brook,2,1,Stony Brook,1
2021-03-21,@Villanova,8,3,Stony Brook,5
2021-03-27,@Pennsylvania,3,0,Pennsylvania,3
2021-03-27,@Pennsylvania,3,2,Pennsylvania,1
2021-03-28,@Villanova,3,2,Pennsylvania,1
2021-04-01,@St. Joseph's,8,7,St. Joseph's,1
2021-04-03,@St. Joseph's,16,5,St. Joseph's,11
2021-04-03,@St. Joseph's,8,2,St. Joseph's,6
2021-04-09,@Creighton,2,9,Creighton,-7
2021-04-10,@Creighton,0,10,Creighton,-10
2021-04-11,@Creighton,0,8,Creighton,-8
2021-04-16,@Villanova,0,1,Seton Hall,-1
2021-04-17,@Villanova,2,13,Seton Hall,-11
2021-04-18,@Villanova,1,4,Seton Hall,-3
2021-04-23,@Butler,5,10,Butler,-5
2021-04-24,@Butler,8,1,Butler,7
2021-04-25,@Butler,3,11,Butler,-8
2021-04-30,@Villanova,2,1,Xavier,1
2021-05-01,@Villanova,0,1,Xavier,-1
2021-05-02,@Villanova,12,5,Xavier,7
2021-05-07,@Villanova,6,4,Georgetown,2
2021-05-08,@Villanova,4,0,Georgetown,4
2021-05-09,@Villanova,2,1,Georgetown,1
2021-05-14,@Villanova,3,2,Connecticut,1
2021-05-15,@Villanova,4,9,Connecticut,-5
2021-05-16,@Villanova,3,4,Connecticut,-1
2021-05-20,@St. John's,5,4,St. John's,1
2021-05-21,@St. John's,7,2,St. John's,5
2021-05-22,@St. John's,1,6,St. John's,-5
2021-02-19,@Virginia,2,1,Connecticut,1
2021-02-20,@Virginia,9,10,Connecticut,-1
2021-02-21,@Virginia,4,2,Connecticut,2
2021-02-23,@Virginia,14,5,VMI,9
2021-02-25,@North Carolina,2,3,North Carolina,-1
2021-02-27,@North Carolina,1,2,North Carolina,-1
2021-02-28,@North Carolina,3,2,North Carolina,1
2021-03-02,@Virginia,11,1,George Washington,10
2021-03-05,@Florida State,0,2,Florida State,-2
2021-03-06,@Florida State,4,9,Florida State,-5
2021-03-07,@Florida State,2,1,Florida State,1
2021-03-09,@Virginia,7,0,Richmond,7
2021-03-12,@Virginia,5,10,Notre Dame,-5
2021-03-13,@Virginia,4,12,Notre Dame,-8
2021-03-14,@Virginia,3,8,Notre Dame,-5
2021-03-17,@Virginia,5,0,Towson,5
2021-03-20,@Virginia,1,2,Pittsburgh,-1
2021-03-21,@Virginia,2,6,Pittsburgh,-4
2021-03-22,@Virginia,10,4,Pittsburgh,6
2021-03-24,@Liberty,2,10,Liberty,-8
2021-03-26,@Virginia,6,8,"Miami, Florida",-2
2021-03-27,@Virginia,4,0,"Miami, Florida",4
2021-03-28,@Virginia,2,4,"Miami, Florida",-2
2021-03-30,@George Washington,7,2,George Washington,5
2021-04-01,@Georgia Tech,5,6,Georgia Tech,-1
2021-04-02,@Georgia Tech,8,2,Georgia Tech,6
2021-04-03,@Georgia Tech,11,4,Georgia Tech,7
2021-04-06,@Virginia,7,6,William and Mary,1
2021-04-09,@Clemson,1,6,Clemson,-5
2021-04-10,@Clemson,8,4,Clemson,4
2021-04-11,@Clemson,6,5,Clemson,1
2021-04-16,@Virginia,8,7,Louisville,1
2021-04-17,@Virginia,5,9,Louisville,-4
2021-04-18,@Virginia,2,8,Louisville,-6
2021-04-20,@Virginia Commonwealth,3,5,Virginia Commonwealth,-2
2021-04-23,@Virginia,9,3,Duke,6
2021-04-24,@Virginia,4,3,Duke,1
2021-04-25,@Virginia,4,7,Duke,-3
2021-04-27,@Virginia,6,5,Liberty,1
2021-04-30,@Virginia Tech,18,1,Virginia Tech,17
2021-05-01,@Virginia Tech,3,6,Virginia Tech,-3
2021-05-02,@Virginia Tech,6,1,Virginia Tech,5
2021-05-04,@Virginia,5,7,Virginia Commonwealth,-2
2021-05-14,@Virginia,17,0,Wake Forest,17
2021-05-15,@Virginia,6,5,Wake Forest,1
2021-05-16,@Virginia,5,4,Wake Forest,1
2021-05-20,@Boston College,7,1,Boston College,6
2021-05-21,@Boston College,9,2,Boston College,7
2021-05-22,@Boston College,6,8,Boston College,-2
2021-05-25,@Virginia,3,2,Virginia Tech,1
2021-05-28,@Notre Dame,14,1,Notre Dame,13
2021-05-29,@Virginia,2,4,Duke,-2
2021-06-04,@South Carolina,3,4,South Carolina,-1
2021-06-05,@Virginia,13,8,Jacksonville,5
2021-06-06,@Old Dominion,8,3,Old Dominion,5
2021-06-06,@Virginia,3,2,South Carolina,1
2021-06-08,@Virginia,4,3,Old Dominion,1
2021-06-12,@Dallas Baptist,5,6,Dallas Baptist,-1
2021-06-13,@Virginia,4,0,Dallas Baptist,4
2021-06-14,@Virginia,5,2,Dallas Baptist,3
2021-06-20,@Tennessee,6,0,Tennessee,6
2021-06-22,@Virginia,5,6,Mississippi State,-1
2021-06-24,@Virginia,2,6,Texas,-4
2021-02-20,@North Carolina-Wilmington,4,5,North Carolina-Wilmington,-1
2021-02-21,@North Carolina-Wilmington,1,4,North Carolina-Wilmington,-3
2021-02-21,@North Carolina-Wilmington,5,9,North Carolina-Wilmington,-4
2021-02-27,@Elon,6,7,Elon,-1
2021-02-27,@Elon,4,3,Elon,1
2021-02-28,@Elon,7,8,Elon,-1
2021-03-02,@Virginia Commonwealth,10,8,VMI,2
2021-03-05,@VMI,17,2,VMI,15
2021-03-06,@Virginia Commonwealth,12,11,Central Michigan,1
2021-03-07,@VMI,18,7,VMI,11
2021-03-09,@Virginia Tech,9,10,Virginia Tech,-1
2021-03-10,@Virginia Tech,10,7,Virginia Tech,3
2021-03-12,@Virginia Commonwealth,14,9,Towson,5
2021-03-13,@Virginia Commonwealth,7,8,Towson,-1
2021-03-14,@Virginia Commonwealth,5,1,Towson,4
2021-03-17,@Old Dominion,12,5,Old Dominion,7
2021-03-20,@Liberty,2,3,Liberty,-1
2021-03-21,@Virginia Commonwealth,1,6,Liberty,-5
2021-03-23,@Virginia Commonwealth,3,5,Old Dominion,-2
2021-03-26,@William and Mary,8,6,William and Mary,2
2021-03-27,@Virginia Commonwealth,6,3,William and Mary,3
2021-03-27,@Virginia Commonwealth,9,4,William and Mary,5
2021-03-30,@Elon,6,3,Elon,3
2021-04-02,@Liberty,3,9,Liberty,-6
2021-04-03,@Virginia Commonwealth,4,2,Liberty,2
2021-04-07,@Georgetown,13,4,Georgetown,9
2021-04-09,@George Washington,6,4,George Washington,2
2021-04-10,@George Washington,4,5,George Washington,-1
2021-04-10,@George Washington,2,3,George Washington,-1
2021-04-11,@George Washington,4,5,George Washington,-1
2021-04-13,@William and Mary,8,3,William and Mary,5
2021-04-16,@Virginia Commonwealth,14,3,Davidson,11
2021-04-17,@Virginia Commonwealth,9,8,Davidson,1
2021-04-17,@Virginia Commonwealth,5,1,Davidson,4
2021-04-18,@Virginia Commonwealth,3,1,Davidson,2
2021-04-20,@Virginia Commonwealth,5,3,Virginia,2
2021-04-27,@Virginia Commonwealth,15,5,VMI,10
2021-04-30,@Virginia Commonwealth,9,2,George Mason,7
2021-05-01,@Virginia Commonwealth,3,1,George Mason,2
2021-05-01,@Virginia Commonwealth,8,1,George Mason,7
2021-05-02,@Virginia Commonwealth,11,2,George Mason,9
2021-05-04,@Virginia,7,5,Virginia,2
2021-05-07,@St. Louis,19,4,St. Louis,15
2021-05-07,@St. Louis,14,6,St. Louis,8
2021-05-08,@St. Louis,9,8,St. Louis,1
2021-05-08,@St. Louis,16,5,St. Louis,11
2021-05-20,@James Madison,20,18,James Madison,2
2021-05-21,@James Madison,10,1,James Madison,9
2021-05-27,@Virginia Commonwealth,15,4,St. Joseph's,11
2021-05-28,@Rhode Island,10,4,Rhode Island,6
2021-05-29,@Dayton,7,6,Dayton,1
2021-06-04,@Virginia Commonwealth,19,4,Campbell,15
2021-06-05,@Mississippi State,4,16,Mississippi State,-12
2021-06-06,@Campbell,10,19,Campbell,-9
2021-02-21,@Virginia Tech,3,1,Kent State,2
2021-02-21,@Virginia Tech,9,2,Kent State,7
2021-02-23,@Virginia Tech,22,2,Radford,20
2021-02-26,"@Miami, Florida",5,3,"Miami, Florida",2
2021-02-27,"@Miami, Florida",0,3,"Miami, Florida",-3
2021-02-28,"@Miami, Florida",9,6,"Miami, Florida",3
2021-03-05,@Virginia Tech,10,6,North Carolina,4
2021-03-06,@Virginia Tech,6,4,North Carolina,2
2021-03-07,@Virginia Tech,6,9,North Carolina,-3
2021-03-09,@Virginia Tech,10,9,Virginia Commonwealth,1
2021-03-10,@Virginia Tech,7,10,Virginia Commonwealth,-3
2021-03-12,@Virginia Tech,4,6,Florida State,-2
2021-03-13,@Virginia Tech,5,0,Florida State,5
2021-03-14,@Virginia Tech,7,14,Florida State,-7
2021-03-16,@Virginia Tech,2,7,North Carolina-Greensboro,-5
2021-03-19,@Clemson,2,8,Clemson,-6
2021-03-20,@Clemson,11,3,Clemson,8
2021-03-21,@Clemson,2,4,Clemson,-2
2021-03-26,@Pittsburgh,5,1,Pittsburgh,4
2021-03-27,@Pittsburgh,8,4,Pittsburgh,4
2021-03-28,@Pittsburgh,8,4,Pittsburgh,4
2021-04-01,@Virginia Tech,3,7,Boston College,-4
2021-04-02,@Virginia Tech,6,5,Boston College,1
2021-04-03,@Virginia Tech,4,3,Boston College,1
2021-04-06,@East Tennessee State,15,5,East Tennessee State,10
2021-04-09,@Wake Forest,8,4,Wake Forest,4
2021-04-10,@Wake Forest,16,4,Wake Forest,12
2021-04-11,@Wake Forest,10,9,Wake Forest,1
2021-04-13,@Liberty,2,8,Liberty,-6
2021-04-16,@Virginia Tech,11,15,Georgia Tech,-4
2021-04-17,@Virginia Tech,7,0,Georgia Tech,7
2021-04-18,@Virginia Tech,4,11,Georgia Tech,-7
2021-04-20,@Virginia Tech,7,5,VMI,2
2021-04-23,@North Carolina State,1,3,North Carolina State,-2
2021-04-25,@North Carolina State,6,7,North Carolina State,-1
2021-04-25,@North Carolina State,3,11,North Carolina State,-8
2021-04-27,@Virginia Tech,12,0,East Tennessee State,12
2021-04-30,@Virginia Tech,1,18,Virginia,-17
2021-05-01,@Virginia Tech,6,3,Virginia,3
2021-05-02,@Virginia Tech,1,6,Virginia,-5
2021-05-05,@Virginia Tech,6,2,Georgetown,4
2021-05-08,@Virginia Tech,7,1,Toledo,6
2021-05-08,@Virginia Tech,3,2,Toledo,1
2021-05-09,@Virginia Tech,16,5,Toledo,11
2021-05-14,@Duke,6,11,Duke,-5
2021-05-15,@Duke,1,4,Duke,-3
2021-05-16,@Duke,1,2,Duke,-1
2021-05-20,@Virginia Tech,2,8,Notre Dame,-6
2021-05-21,@Virginia Tech,0,4,Notre Dame,-4
2021-05-22,@Virginia Tech,1,7,Notre Dame,-6
2021-05-25,@Virginia,2,3,Virginia,-1
2021-05-26,@Virginia Tech,0,8,Notre Dame,-8
2021-03-06,@Lafayette,14,12,Lafayette,2
2021-03-06,@Lafayette,3,5,Lafayette,-2
2021-03-13,@Wagner,6,2,Maine,4
2021-03-13,@Wagner,1,5,Maine,-4
2021-03-14,@Wagner,3,12,Maine,-9
2021-03-19,@Fairleigh Dickinson,17,3,Fairleigh Dickinson,14
2021-03-20,@Fairleigh Dickinson,3,7,Fairleigh Dickinson,-4
2021-03-21,@Fairleigh Dickinson,6,4,Fairleigh Dickinson,2
2021-03-26,@Wagner,8,15,Sacred Heart,-7
2021-03-27,@Wagner,3,13,Sacred Heart,-10
2021-03-27,@Wagner,2,5,Sacred Heart,-3
2021-04-01,@Bryant,1,12,Bryant,-11
2021-04-02,@Bryant,3,9,Bryant,-6
2021-04-03,@Bryant,4,1,Bryant,3
2021-04-09,@Wagner,1,5,LIU-Brooklyn,-4
2021-04-10,@Wagner,3,14,LIU-Brooklyn,-11
2021-04-10,@Wagner,8,3,LIU-Brooklyn,5
2021-04-17,@Merrimack,3,5,Merrimack,-2
2021-04-18,@Merrimack,2,3,Merrimack,-1
2021-04-18,@Merrimack,1,2,Merrimack,-1
2021-04-20,@Fairleigh Dickinson,11,10,Fairleigh Dickinson,1
2021-04-23,@Mount St. Mary's,4,16,Mount St. Mary's,-12
2021-04-24,@Mount St. Mary's,16,3,Mount St. Mary's,13
2021-04-25,@Mount St. Mary's,1,7,Mount St. Mary's,-6
2021-04-30,@Wagner,2,6,Central Connecticut State,-4
2021-05-01,@Wagner,3,9,Central Connecticut State,-6
2021-05-02,@Wagner,3,6,Central Connecticut State,-3
2021-05-07,@Fairleigh Dickinson,2,3,Fairleigh Dickinson,-1
2021-05-08,@Fairleigh Dickinson,5,1,Fairleigh Dickinson,4
2021-05-09,@Fairleigh Dickinson,5,6,Fairleigh Dickinson,-1
2021-05-14,@Wagner,6,4,Bryant,2
2021-05-15,@Wagner,0,6,Bryant,-6
2021-05-16,@Wagner,5,7,Bryant,-2
2021-05-21,@Sacred Heart,2,3,Sacred Heart,-1
2021-05-21,@Sacred Heart,9,7,Sacred Heart,2
2021-05-22,@Sacred Heart,6,14,Sacred Heart,-8
2021-02-19,@Wake Forest,8,6,Northeastern,2
2021-02-20,@Wake Forest,9,0,Northeastern,9
2021-02-21,@Wake Forest,11,14,Northeastern,-3
2021-02-23,@Wake Forest,1,4,Coastal Carolina,-3
2021-02-27,@Wake Forest,10,8,Notre Dame,2
2021-02-27,@Wake Forest,4,5,Notre Dame,-1
2021-02-28,@Wake Forest,0,10,Notre Dame,-10
2021-03-12,"@Miami, Florida",0,10,"Miami, Florida",-10
2021-03-13,"@Miami, Florida",3,6,"Miami, Florida",-3
2021-03-16,@Wake Forest,4,1,North Carolina-Charlotte,3
2021-03-19,@Wake Forest,6,2,Georgia Tech,4
2021-03-20,@Wake Forest,1,3,Georgia Tech,-2
2021-03-21,@Wake Forest,1,8,Georgia Tech,-7
2021-03-23,@Elon,4,2,Elon,2
2021-03-26,@Florida State,1,2,Florida State,-1
2021-03-27,@Florida State,8,7,Florida State,1
2021-03-28,@Florida State,12,10,Florida State,2
2021-03-30,@Wake Forest,15,7,Appalachian State,8
2021-04-02,@Louisville,3,5,Louisville,-2
2021-04-03,@Louisville,7,9,Louisville,-2
2021-04-04,@Louisville,6,3,Louisville,3
2021-04-07,@Liberty,4,8,Liberty,-4
2021-04-09,@Wake Forest,4,8,Virginia Tech,-4
2021-04-10,@Wake Forest,4,16,Virginia Tech,-12
2021-04-11,@Wake Forest,9,10,Virginia Tech,-1
2021-04-13,@Appalachian State,12,0,Appalachian State,12
2021-04-16,@Duke,11,0,Duke,11
2021-04-17,@Duke,2,11,Duke,-9
2021-04-18,@Duke,7,11,Duke,-4
2021-04-20,@Western Carolina,14,8,Western Carolina,6
2021-04-23,@Clemson,2,5,Clemson,-3
2021-04-25,@Clemson,4,6,Clemson,-2
2021-04-25,@Clemson,2,3,Clemson,-1
2021-04-27,@Wake Forest,17,12,Davidson,5
2021-04-30,@Wake Forest,7,13,North Carolina State,-6
2021-05-01,@Wake Forest,14,11,North Carolina State,3
2021-05-02,@Wake Forest,8,15,North Carolina State,-7
2021-05-08,@Wake Forest,2,5,Elon,-3
2021-05-09,@Wake Forest,11,1,Belmont,10
2021-05-09,@Wake Forest,10,1,Belmont,9
2021-05-14,@Virginia,0,17,Virginia,-17
2021-05-15,@Virginia,5,6,Virginia,-1
2021-05-16,@Virginia,4,5,Virginia,-1
2021-05-18,@Coastal Carolina,9,14,Coastal Carolina,-5
2021-05-20,@Wake Forest,6,1,Pittsburgh,5
2021-05-21,@Wake Forest,12,5,Pittsburgh,7
2021-05-22,@Wake Forest,10,2,Pittsburgh,8
2021-02-20,@UC Irvine,4,5,UC Irvine,-1
2021-02-21,@UC Irvine,4,5,UC Irvine,-1
2021-02-22,@UC Irvine,1,3,UC Irvine,-2
2021-02-27,@Washington,10,3,Texas-Rio Grande Valley,7
2021-02-27,@Washington,3,2,Texas-Rio Grande Valley,1
2021-02-28,@Washington,6,0,Texas-Rio Grande Valley,6
2021-03-01,@Washington,0,2,Texas-Rio Grande Valley,-2
2021-03-05,@Washington,1,2,Loyola Marymount,-1
2021-03-06,@Washington,7,2,Loyola Marymount,5
2021-03-07,@Washington,2,3,Loyola Marymount,-1
2021-03-09,@Washington,2,1,Portland,1
2021-03-11,@Washington,7,3,Seattle,4
2021-03-12,@Washington,4,3,Seattle,1
2021-03-13,@Washington,6,4,Seattle,2
2021-03-19,@Washington,2,3,Southern California,-1
2021-03-20,@Washington,5,7,Southern California,-2
2021-03-21,@Washington,3,11,Southern California,-8
2021-03-23,@Gonzaga,2,7,Gonzaga,-5
2021-03-26,@Washington,0,3,Oregon State,-3
2021-03-27,@Washington,1,8,Oregon State,-7
2021-03-29,@Washington,3,13,Oregon State,-10
2021-04-01,@UCLA,8,6,UCLA,2
2021-04-02,@UCLA,7,6,UCLA,1
2021-04-03,@UCLA,2,13,UCLA,-11
2021-04-09,@Washington,2,3,Arizona State,-1
2021-04-10,@Washington,1,8,Arizona State,-7
2021-04-11,@Washington,13,6,Arizona State,7
2021-04-13,@Portland,6,4,Portland,2
2021-04-16,@Washington,10,5,Texas State,5
2021-04-17,@Washington,6,3,Texas State,3
2021-04-18,@Washington,2,1,Texas State,1
2021-04-20,@Washington,0,3,Gonzaga,-3
2021-04-23,@Washington,4,3,New Mexico,1
2021-04-24,@Washington,3,5,New Mexico,-2
2021-04-25,@Washington,3,2,New Mexico,1
2021-04-30,@Washington,0,9,California,-9
2021-05-01,@Washington,1,5,California,-4
2021-05-02,@Washington,2,3,California,-1
2021-05-07,@Oregon,0,8,Oregon,-8
2021-05-08,@Oregon,1,5,Oregon,-4
2021-05-09,@Oregon,3,9,Oregon,-6
2021-05-14,@Arizona,16,17,Arizona,-1
2021-05-15,@Arizona,1,4,Arizona,-3
2021-05-16,@Arizona,2,11,Arizona,-9
2021-05-21,@Washington,3,7,Utah,-4
2021-05-22,@Washington,2,1,Utah,1
2021-05-23,@Washington,6,5,Utah,1
2021-05-27,@Washington State,1,8,Washington State,-7
2021-05-28,@Washington State,14,7,Washington State,7
2021-05-29,@Washington State,1,9,Washington State,-8
2021-02-19,@UC Davis,11,1,UC Davis,10
2021-02-20,@UC Davis,12,5,UC Davis,7
2021-02-21,@UC Davis,5,3,UC Davis,2
2021-02-21,@UC Davis,5,13,UC Davis,-8
2021-02-25,@Dixie State,6,3,Dixie State,3
2021-02-26,@Dixie State,19,5,Dixie State,14
2021-02-27,@Dixie State,15,1,Dixie State,14
2021-02-28,@Dixie State,10,3,Dixie State,7
2021-03-05,@Washington State,6,1,Seattle,5
2021-03-06,@Washington State,14,7,Seattle,7
2021-03-07,@Washington State,2,6,Seattle,-4
2021-03-17,@Portland,6,4,Portland,2
2021-03-19,@Oregon State,5,2,Oregon State,3
2021-03-20,@Oregon State,3,10,Oregon State,-7
2021-03-21,@Oregon State,8,9,Oregon State,-1
2021-03-23,@Nevada-Las Vegas,10,5,Nevada-Las Vegas,5
2021-03-24,@Nevada-Las Vegas,8,15,Nevada-Las Vegas,-7
2021-03-26,@Arizona State,0,10,Arizona State,-10
2021-03-27,@Arizona State,4,5,Arizona State,-1
2021-03-28,@Arizona State,0,9,Arizona State,-9
2021-04-01,@Washington State,3,18,Stanford,-15
2021-04-02,@Washington State,5,7,Stanford,-2
2021-04-03,@Washington State,10,9,Stanford,1
2021-04-07,@Utah Valley,5,3,Utah Valley,2
2021-04-09,@Utah,12,7,Utah,5
2021-04-10,@Utah,7,10,Utah,-3
2021-04-11,@Utah,5,3,Utah,2
2021-04-13,@Washington State,0,9,Gonzaga,-9
2021-04-16,@Washington State,21,2,Arizona,19
2021-04-17,@Washington State,8,13,Arizona,-5
2021-04-18,@Washington State,8,14,Arizona,-6
2021-04-23,@California,2,3,California,-1
2021-04-24,@California,4,2,California,2
2021-04-25,@California,4,3,California,1
2021-04-27,@Gonzaga,5,7,Gonzaga,-2
2021-04-30,@Washington State,0,13,Oregon,-13
2021-05-01,@Washington State,11,1,Oregon,10
2021-05-02,@Washington State,11,6,Oregon,5
2021-05-05,@Washington State,16,8,Seattle,8
2021-05-07,@Washington State,5,2,UCLA,3
2021-05-08,@Washington State,6,7,UCLA,-1
2021-05-09,@Washington State,7,16,UCLA,-9
2021-05-11,@Washington State,6,10,Portland,-4
2021-05-14,@Southern California,6,8,Southern California,-2
2021-05-15,@Southern California,2,3,Southern California,-1
2021-05-16,@Southern California,13,2,Southern California,11
2021-05-27,@Washington State,8,1,Washington,7
2021-05-28,@Washington State,7,14,Washington,-7
2021-05-29,@Washington State,9,1,Washington,8
2021-02-19,@Georgia State,5,3,Georgia State,2
2021-02-20,@Georgia State,6,7,Georgia State,-1
2021-02-20,@Georgia State,4,20,Georgia State,-16
2021-02-21,@Georgia State,3,2,Georgia State,1
2021-02-26,@West Virginia,13,3,Kennesaw State,10
2021-02-27,@Coastal Carolina,5,10,Coastal Carolina,-5
2021-02-28,@Bryant,9,7,Bryant,2
2021-03-12,@West Virginia,3,5,Central Michigan,-2
2021-03-13,@West Virginia,4,12,Central Michigan,-8
2021-03-13,@West Virginia,8,7,Central Michigan,1
2021-03-16,@West Virginia,7,1,Morehead State,6
2021-03-17,@West Virginia,4,2,Morehead State,2
2021-03-19,@West Virginia,2,5,Coastal Carolina,-3
2021-03-20,@West Virginia,5,4,Coastal Carolina,1
2021-03-21,@West Virginia,6,9,Coastal Carolina,-3
2021-03-23,@Marshall,1,7,Marshall,-6
2021-03-26,@West Virginia,11,0,Kansas,11
2021-03-27,@West Virginia,2,9,Kansas,-7
2021-03-27,@West Virginia,15,2,Kansas,13
2021-04-01,@Oklahoma State,4,3,Oklahoma State,1
2021-04-02,@Oklahoma State,2,7,Oklahoma State,-5
2021-04-03,@Oklahoma State,11,21,Oklahoma State,-10
2021-04-06,@Pittsburgh,1,5,Pittsburgh,-4
2021-04-09,@Baylor,3,6,Baylor,-3
2021-04-10,@Baylor,4,7,Baylor,-3
2021-04-11,@Baylor,8,4,Baylor,4
2021-04-14,@West Virginia,9,3,Marshall,6
2021-04-16,@West Virginia,2,7,Texas Tech,-5
2021-04-17,@West Virginia,6,5,Texas Tech,1
2021-04-18,@West Virginia,1,10,Texas Tech,-9
2021-04-23,@Kansas State,4,3,Kansas State,1
2021-04-24,@Kansas State,2,5,Kansas State,-3
2021-04-25,@Kansas State,4,9,Kansas State,-5
2021-04-30,@West Virginia,2,8,Texas Christian,-6
2021-05-01,@West Virginia,3,5,Texas Christian,-2
2021-05-02,@West Virginia,1,9,Texas Christian,-8
2021-05-05,@West Virginia,8,2,Pittsburgh,6
2021-05-07,@West Virginia,7,1,Oklahoma,6
2021-05-08,@West Virginia,1,9,Oklahoma,-8
2021-05-08,@West Virginia,7,8,Oklahoma,-1
2021-05-11,@West Virginia,4,1,Marshall,3
2021-05-14,@West Virginia,7,6,"Miami, Ohio",1
2021-05-15,@West Virginia,6,3,"Miami, Ohio",3
2021-05-16,@West Virginia,12,6,Dayton,6
2021-05-16,@West Virginia,7,6,Dayton,1
2021-05-20,@Texas,5,4,Texas,1
2021-05-21,@Texas,3,14,Texas,-11
2021-05-22,@Texas,2,12,Texas,-10
2021-05-25,@West Virginia,8,7,Kansas,1
2021-05-26,@Texas,5,1,Texas,4
2021-05-28,@Oklahoma State,2,12,Oklahoma State,-10
2021-05-28,@Texas,2,3,Texas,-1
2021-02-19,@Western Carolina,23,1,Towson,22
2021-02-20,@Western Carolina,15,5,Towson,10
2021-02-20,@Western Carolina,4,3,Towson,1
2021-02-21,@Western Carolina,5,1,Towson,4
2021-02-23,@Western Carolina,4,10,North Carolina-Asheville,-6
2021-02-26,@North Carolina-Wilmington,8,2,North Carolina-Wilmington,6
2021-02-27,@North Carolina-Wilmington,6,8,North Carolina-Wilmington,-2
2021-02-28,@North Carolina-Wilmington,6,10,North Carolina-Wilmington,-4
2021-03-05,@North Carolina-Charlotte,4,7,North Carolina-Charlotte,-3
2021-03-06,@North Carolina-Charlotte,5,2,North Carolina-Charlotte,3
2021-03-07,@North Carolina-Charlotte,10,5,North Carolina-Charlotte,5
2021-03-10,@Western Carolina,12,11,Kennesaw State,1
2021-03-12,@Western Carolina,11,1,St. John's,10
2021-03-13,@Western Carolina,21,3,St. John's,18
2021-03-14,@Western Carolina,8,3,St. John's,5
2021-03-26,@Western Carolina,11,6,The Citadel,5
2021-03-26,@Western Carolina,12,8,The Citadel,4
2021-03-30,@Tennessee,2,9,Tennessee,-7
2021-04-02,@Wofford,5,6,Wofford,-1
2021-04-03,@Wofford,9,12,Wofford,-3
2021-04-03,@Wofford,11,6,Wofford,5
2021-04-07,@Gardner-Webb,12,2,Gardner-Webb,10
2021-04-10,@Western Carolina,3,0,VMI,3
2021-04-11,@Western Carolina,9,8,VMI,1
2021-04-11,@Western Carolina,16,12,VMI,4
2021-04-13,@Western Carolina,12,14,Tennessee,-2
2021-04-16,@Western Carolina,5,8,Samford,-3
2021-04-16,@Western Carolina,7,2,Samford,5
2021-04-17,@Western Carolina,12,11,Samford,1
2021-04-20,@Western Carolina,8,14,Wake Forest,-6
2021-04-23,@East Tennessee State,3,0,East Tennessee State,3
2021-04-23,@East Tennessee State,1,7,East Tennessee State,-6
2021-04-28,@Elon,3,4,Elon,-1
2021-04-30,@North Carolina-Greensboro,8,17,North Carolina-Greensboro,-9
2021-05-01,@North Carolina-Greensboro,7,1,North Carolina-Greensboro,6
2021-05-01,@North Carolina-Greensboro,4,6,North Carolina-Greensboro,-2
2021-05-07,@Western Carolina,7,8,Mercer,-1
2021-05-07,@Western Carolina,9,11,Mercer,-2
2021-05-08,@Western Carolina,1,14,Mercer,-13
2021-05-14,@Western Carolina,2,13,Wofford,-11
2021-05-15,@Western Carolina,10,20,Wofford,-10
2021-05-15,@Western Carolina,8,4,Wofford,4
2021-05-20,@The Citadel,2,1,The Citadel,1
2021-05-21,@The Citadel,21,0,The Citadel,21
2021-05-21,@The Citadel,6,3,The Citadel,3
2021-05-27,@Wofford,16,5,Wofford,11
2021-05-29,@Samford,7,19,Samford,-12
2021-05-29,@Wofford,11,6,Wofford,5
2021-05-30,@Samford,6,8,Samford,-2
2021-02-26,@Louisville,8,3,Louisville,5
2021-02-27,@Louisville,4,9,Louisville,-5
2021-02-27,@Louisville,1,4,Louisville,-3
2021-03-02,@Southern Illinois,1,9,Southern Illinois,-8
2021-03-05,@Evansville,0,11,Evansville,-11
2021-03-06,@Evansville,7,6,Evansville,1
2021-03-06,@Evansville,2,3,Evansville,-1
2021-03-07,@Evansville,10,11,Evansville,-1
2021-03-09,@Illinois State,1,2,Illinois State,-1
2021-03-12,@St. Louis,3,4,St. Louis,-1
2021-03-13,@St. Louis,11,0,St. Louis,11
2021-03-14,@St. Louis,0,14,St. Louis,-14
2021-03-16,@Southern Illinois-Edwardsville,6,5,Southern Illinois-Edwardsville,1
2021-03-19,@Western Illinois,2,11,North Dakota State,-9
2021-03-20,@Western Illinois,4,8,North Dakota State,-4
2021-03-20,@Western Illinois,3,7,North Dakota State,-4
2021-03-21,@Western Illinois,9,7,North Dakota State,2
2021-03-26,@Western Illinois,5,0,South Dakota State,5
2021-03-26,@Western Illinois,3,10,South Dakota State,-7
2021-03-27,@Western Illinois,4,3,South Dakota State,1
2021-03-28,@Western Illinois,6,5,South Dakota State,1
2021-04-01,@Western Illinois,4,6,Oral Roberts,-2
2021-04-02,@Western Illinois,0,10,Oral Roberts,-10
2021-04-02,@Western Illinois,9,8,Oral Roberts,1
2021-04-03,@Western Illinois,5,18,Oral Roberts,-13
2021-04-09,@North Dakota State,0,2,North Dakota State,-2
2021-04-10,@North Dakota State,7,10,North Dakota State,-3
2021-04-10,@North Dakota State,3,6,North Dakota State,-3
2021-04-11,@North Dakota State,5,6,North Dakota State,-1
2021-04-30,@Nebraska-Omaha,1,11,Nebraska-Omaha,-10
2021-05-01,@Nebraska-Omaha,2,12,Nebraska-Omaha,-10
2021-05-02,@Nebraska-Omaha,13,15,Nebraska-Omaha,-2
2021-05-07,@Oral Roberts,2,3,Oral Roberts,-1
2021-05-07,@Oral Roberts,5,4,Oral Roberts,1
2021-05-08,@Oral Roberts,1,9,Oral Roberts,-8
2021-05-09,@Oral Roberts,0,10,Oral Roberts,-10
2021-05-20,@Western Illinois,1,7,Nebraska-Omaha,-6
2021-05-20,@Western Illinois,12,7,Nebraska-Omaha,5
2021-05-21,@Western Illinois,0,13,Nebraska-Omaha,-13
2021-05-22,@Western Illinois,6,8,Nebraska-Omaha,-2
2021-02-21,@Western Kentucky,10,4,North Dakota State,6
2021-02-22,@Western Kentucky,5,8,North Dakota State,-3
2021-02-22,@Western Kentucky,2,10,North Dakota State,-8
2021-02-24,@Vanderbilt,1,12,Vanderbilt,-11
2021-02-26,@Western Kentucky,5,4,Cincinnati,1
2021-02-27,@Western Kentucky,3,11,Cincinnati,-8
2021-02-27,@Western Kentucky,5,4,Cincinnati,1
2021-03-05,@Tulane,5,6,Tulane,-1
2021-03-06,@Tulane,2,5,Tulane,-3
2021-03-07,@Tulane,8,7,Tulane,1
2021-03-09,@Kentucky,5,6,Kentucky,-1
2021-03-12,@Western Kentucky,4,3,Bowling Green State,1
2021-03-13,@Western Kentucky,3,1,Bowling Green State,2
2021-03-13,@Western Kentucky,4,1,Bowling Green State,3
2021-03-14,@Western Kentucky,17,16,Bowling Green State,1
2021-03-16,@Western Kentucky,3,7,Bellarmine,-4
2021-03-19,@Western Kentucky,8,4,Valparaiso,4
2021-03-20,@Western Kentucky,6,8,Valparaiso,-2
2021-03-21,@Western Kentucky,11,1,Valparaiso,10
2021-03-23,@Louisville,6,13,Louisville,-7
2021-03-26,@Western Kentucky,4,7,North Carolina-Charlotte,-3
2021-03-27,@Western Kentucky,0,6,North Carolina-Charlotte,-6
2021-03-27,@Western Kentucky,4,5,North Carolina-Charlotte,-1
2021-03-28,@Western Kentucky,17,16,North Carolina-Charlotte,1
2021-04-01,@Florida International,9,2,Florida International,7
2021-04-02,@Florida International,2,3,Florida International,-1
2021-04-02,@Florida International,1,2,Florida International,-1
2021-04-03,@Florida International,0,10,Florida International,-10
2021-04-09,@Western Kentucky,1,0,Marshall,1
2021-04-09,@Western Kentucky,5,1,Marshall,4
2021-04-10,@Western Kentucky,5,2,Marshall,3
2021-04-11,@Western Kentucky,8,1,Marshall,7
2021-04-16,@Western Kentucky,5,7,Middle Tennessee State,-2
2021-04-17,@Western Kentucky,5,4,Middle Tennessee State,1
2021-04-17,@Western Kentucky,0,3,Middle Tennessee State,-3
2021-04-18,@Western Kentucky,3,1,Middle Tennessee State,2
2021-04-23,@Southern Mississippi,5,6,Southern Mississippi,-1
2021-04-24,@Southern Mississippi,5,6,Southern Mississippi,-1
2021-04-24,@Southern Mississippi,0,3,Southern Mississippi,-3
2021-04-25,@Southern Mississippi,9,4,Southern Mississippi,5
2021-04-30,@Marshall,10,6,Marshall,4
2021-05-01,@Marshall,6,1,Marshall,5
2021-05-01,@Marshall,15,5,Marshall,10
2021-05-02,@Marshall,10,6,Marshall,4
2021-05-07,@Western Kentucky,3,6,Florida Atlantic,-3
2021-05-07,@Western Kentucky,6,5,Florida Atlantic,1
2021-05-08,@Western Kentucky,3,6,Florida Atlantic,-3
2021-05-08,@Western Kentucky,1,6,Florida Atlantic,-5
2021-05-14,@Old Dominion,8,14,Old Dominion,-6
2021-05-15,@Old Dominion,3,6,Old Dominion,-3
2021-05-15,@Old Dominion,7,6,Old Dominion,1
2021-05-16,@Old Dominion,2,13,Old Dominion,-11
2021-05-18,@Western Kentucky,4,3,Eastern Kentucky,1
2021-05-26,@Southern Mississippi,1,11,Southern Mississippi,-10
2021-05-27,@Western Kentucky,10,9,Texas-San Antonio,1
2021-05-28,@Louisiana Tech,4,14,Louisiana Tech,-10
2021-02-26,@Kansas State,8,9,Kansas State,-1
2021-02-27,@Kansas State,3,11,Kansas State,-8
2021-02-28,@Kansas State,1,2,Kansas State,-1
2021-03-12,@Cincinnati,1,5,Cincinnati,-4
2021-03-13,@Cincinnati,5,7,Cincinnati,-2
2021-03-14,@Cincinnati,4,5,Cincinnati,-1
2021-03-19,@Ball State,0,2,Ball State,-2
2021-03-20,@Ball State,2,3,Ball State,-1
2021-03-20,@Ball State,1,13,Ball State,-12
2021-03-21,@Ball State,15,12,Ball State,3
2021-03-27,@Western Michigan,4,9,Eastern Michigan,-5
2021-03-28,@Western Michigan,8,1,Eastern Michigan,7
2021-03-29,@Western Michigan,4,5,Eastern Michigan,-1
2021-03-29,@Western Michigan,3,1,Eastern Michigan,2
2021-04-02,@Western Michigan,10,0,Akron,10
2021-04-03,@Western Michigan,13,2,Akron,11
2021-04-03,@Western Michigan,7,6,Akron,1
2021-04-04,@Western Michigan,3,0,Akron,3
2021-04-09,"@Miami, Ohio",4,3,"Miami, Ohio",1
2021-04-09,"@Miami, Ohio",9,0,"Miami, Ohio",9
2021-04-10,"@Miami, Ohio",3,2,"Miami, Ohio",1
2021-04-11,"@Miami, Ohio",9,16,"Miami, Ohio",-7
2021-04-16,@Western Michigan,4,13,Southern Illinois-Edwardsville,-9
2021-04-17,@Western Michigan,2,6,Southern Illinois-Edwardsville,-4
2021-04-17,@Western Michigan,10,2,Southern Illinois-Edwardsville,8
2021-04-18,@Western Michigan,1,8,Southern Illinois-Edwardsville,-7
2021-04-23,@Western Michigan,12,7,Bowling Green State,5
2021-04-23,@Western Michigan,7,5,Bowling Green State,2
2021-04-24,@Western Michigan,2,3,Bowling Green State,-1
2021-04-25,@Western Michigan,6,20,Bowling Green State,-14
2021-04-30,@Toledo,16,13,Toledo,3
2021-05-01,@Toledo,15,6,Toledo,9
2021-05-01,@Toledo,10,11,Toledo,-1
2021-05-02,@Toledo,9,16,Toledo,-7
2021-05-07,@Northern Illinois,10,8,Northern Illinois,2
2021-05-08,@Northern Illinois,5,2,Northern Illinois,3
2021-05-08,@Northern Illinois,2,5,Northern Illinois,-3
2021-05-09,@Northern Illinois,5,15,Northern Illinois,-10
2021-05-14,@Western Michigan,8,3,Central Michigan,5
2021-05-15,@Western Michigan,10,3,Central Michigan,7
2021-05-15,@Western Michigan,0,11,Central Michigan,-11
2021-05-16,@Western Michigan,6,1,Central Michigan,5
2021-05-21,@Kent State,4,14,Kent State,-10
2021-05-22,@Kent State,6,5,Kent State,1
2021-05-22,@Kent State,2,9,Kent State,-7
2021-05-23,@Kent State,10,11,Kent State,-1
2021-05-28,@Western Michigan,5,8,Ohio,-3
2021-05-29,@Western Michigan,4,3,Ohio,1
2021-05-29,@Western Michigan,4,2,Ohio,2
2021-05-30,@Western Michigan,6,3,Ohio,3
2021-02-21,@Wichita State,1,3,Oklahoma State,-2
2021-02-22,@Wichita State,6,14,Oklahoma State,-8
2021-02-26,@Wichita State,10,4,Southern Illinois-Edwardsville,6
2021-02-27,@Wichita State,7,9,Southern Illinois-Edwardsville,-2
2021-02-28,@Wichita State,7,5,Southern Illinois-Edwardsville,2
2021-03-02,@Oral Roberts,3,0,Oral Roberts,3
2021-03-05,@Wichita State,2,1,Dixie State,1
2021-03-06,@Wichita State,15,3,Dixie State,12
2021-03-07,@Wichita State,15,7,Dixie State,8
2021-03-11,@Arizona,5,8,Arizona,-3
2021-03-12,@Arizona,10,9,Arizona,1
2021-03-13,@Air Force,3,12,Air Force,-9
2021-03-19,@Stetson,4,9,Stetson,-5
2021-03-19,@Wichita State,2,11,Florida International,-9
2021-03-20,@Stetson,11,8,Stetson,3
2021-03-21,@Florida International,2,9,Florida International,-7
2021-03-23,@Wichita State,5,1,Kansas State,4
2021-03-26,@Wichita State,14,5,Nebraska-Omaha,9
2021-03-27,@Wichita State,9,0,Nebraska-Omaha,9
2021-03-28,@Wichita State,11,1,Nebraska-Omaha,10
2021-04-01,@Houston,3,5,Houston,-2
2021-04-02,@Houston,2,1,Houston,1
2021-04-02,@Houston,3,2,Houston,1
2021-04-03,@Houston,3,2,Houston,1
2021-04-09,@Wichita State,7,1,Houston,6
2021-04-09,@Wichita State,10,2,Houston,8
2021-04-10,@Wichita State,10,1,Houston,9
2021-04-11,@Wichita State,13,2,Houston,11
2021-04-16,@Tulane,3,6,Tulane,-3
2021-04-16,@Tulane,2,3,Tulane,-1
2021-04-18,@Tulane,7,8,Tulane,-1
2021-04-23,@Cincinnati,0,6,Cincinnati,-6
2021-04-23,@Cincinnati,2,12,Cincinnati,-10
2021-04-24,@Cincinnati,6,1,Cincinnati,5
2021-04-25,@Cincinnati,5,6,Cincinnati,-1
2021-04-30,@Wichita State,12,2,East Carolina,10
2021-04-30,@Wichita State,0,10,East Carolina,-10
2021-05-01,@Wichita State,3,11,East Carolina,-8
2021-05-02,@Wichita State,11,9,East Carolina,2
2021-05-07,@Central Florida,3,6,Central Florida,-3
2021-05-07,@Central Florida,11,1,Central Florida,10
2021-05-08,@Central Florida,10,3,Central Florida,7
2021-05-09,@Central Florida,7,6,Central Florida,1
2021-05-14,@Wichita State,2,8,South Florida,-6
2021-05-14,@Wichita State,9,3,South Florida,6
2021-05-15,@Wichita State,1,7,South Florida,-6
2021-05-16,@Wichita State,6,4,South Florida,2
2021-05-20,@Wichita State,8,5,Memphis,3
2021-05-20,@Wichita State,12,5,Memphis,7
2021-05-21,@Wichita State,9,5,Memphis,4
2021-05-22,@Wichita State,4,9,Memphis,-5
2021-05-25,@Wichita State,2,7,South Florida,-5
2021-05-26,@Wichita State,5,3,Houston,2
2021-05-28,@Tulane,2,12,Tulane,-10
2021-02-27,@North Carolina-Charlotte,1,7,North Carolina-Charlotte,-6
2021-02-27,@North Carolina-Charlotte,0,4,North Carolina-Charlotte,-4
2021-02-28,@North Carolina-Charlotte,4,20,North Carolina-Charlotte,-16
2021-03-06,@George Mason,4,1,George Mason,3
2021-03-07,@William and Mary,3,7,Central Michigan,-4
2021-03-07,@William and Mary,1,12,Central Michigan,-11
2021-03-10,@William and Mary,2,8,Old Dominion,-6
2021-03-12,@College of Charleston,7,3,College of Charleston,4
2021-03-13,@College of Charleston,4,6,College of Charleston,-2
2021-03-13,@College of Charleston,1,7,College of Charleston,-6
2021-03-20,@William and Mary,5,4,North Carolina-Wilmington,1
2021-03-20,@William and Mary,7,6,North Carolina-Wilmington,1
2021-03-21,@William and Mary,1,4,North Carolina-Wilmington,-3
2021-03-26,@William and Mary,6,8,Virginia Commonwealth,-2
2021-03-27,@Virginia Commonwealth,4,9,Virginia Commonwealth,-5
2021-03-27,@Virginia Commonwealth,3,6,Virginia Commonwealth,-3
2021-04-02,@William and Mary,4,3,Richmond,1
2021-04-04,@Richmond,4,5,Richmond,-1
2021-04-04,@Richmond,10,6,Richmond,4
2021-04-06,@Virginia,6,7,Virginia,-1
2021-04-10,@Elon,7,13,Elon,-6
2021-04-10,@Elon,6,7,Elon,-1
2021-04-11,@Elon,0,8,Elon,-8
2021-04-13,@William and Mary,3,8,Virginia Commonwealth,-5
2021-04-17,@William and Mary,12,9,Elon,3
2021-04-17,@William and Mary,6,4,Elon,2
2021-04-18,@William and Mary,9,7,Elon,2
2021-04-24,@William and Mary,5,9,James Madison,-4
2021-04-25,@William and Mary,1,0,James Madison,1
2021-04-25,@William and Mary,10,3,James Madison,7
2021-04-30,@North Carolina-Wilmington,5,3,North Carolina-Wilmington,2
2021-05-01,@North Carolina-Wilmington,0,11,North Carolina-Wilmington,-11
2021-05-02,@North Carolina-Wilmington,0,1,North Carolina-Wilmington,-1
2021-05-04,@Duke,6,11,Duke,-5
2021-05-07,@William and Mary,4,9,College of Charleston,-5
2021-05-08,@William and Mary,1,10,College of Charleston,-9
2021-05-08,@William and Mary,4,5,College of Charleston,-1
2021-05-15,@James Madison,7,4,James Madison,3
2021-05-15,@James Madison,7,10,James Madison,-3
2021-05-16,@James Madison,9,10,James Madison,-1
2021-05-26,@Elon,3,7,Elon,-4
2021-05-27,@Towson,7,3,Towson,4
2021-05-28,@William and Mary,3,8,College of Charleston,-5
2021-02-20,@Winthrop,1,4,Appalachian State,-3
2021-02-20,@Winthrop,0,4,Appalachian State,-4
2021-02-21,@Winthrop,10,9,Appalachian State,1
2021-02-23,@South Carolina,4,12,South Carolina,-8
2021-02-27,@Winthrop,2,7,Towson,-5
2021-02-27,@Winthrop,7,3,Towson,4
2021-02-28,@Winthrop,5,4,Towson,1
2021-03-02,@Winthrop,8,19,South Carolina,-11
2021-03-20,@Longwood,3,7,Longwood,-4
2021-03-20,@Longwood,6,5,Longwood,1
2021-03-21,@Longwood,14,6,Longwood,8
2021-03-23,@Winthrop,4,1,Charleston Southern,3
2021-03-26,@Winthrop,0,5,South Carolina-Upstate,-5
2021-03-27,@Winthrop,5,2,South Carolina-Upstate,3
2021-03-27,@Winthrop,2,1,South Carolina-Upstate,1
2021-04-02,@Campbell,1,8,Campbell,-7
2021-04-02,@Campbell,5,6,Campbell,-1
2021-04-03,@Campbell,6,15,Campbell,-9
2021-04-06,@Winthrop,11,28,Campbell,-17
2021-04-09,@Winthrop,3,11,North Carolina-Asheville,-8
2021-04-09,@Winthrop,7,12,North Carolina-Asheville,-5
2021-04-10,@Winthrop,10,8,North Carolina-Asheville,2
2021-04-13,@Gardner-Webb,4,5,Gardner-Webb,-1
2021-04-16,@Radford,9,7,Radford,2
2021-04-17,@Radford,4,6,Radford,-2
2021-04-17,@Radford,1,11,Radford,-10
2021-04-20,@Charleston Southern,13,5,Charleston Southern,8
2021-04-23,@Gardner-Webb,1,13,Gardner-Webb,-12
2021-04-23,@Gardner-Webb,7,8,Gardner-Webb,-1
2021-04-25,@Gardner-Webb,7,9,Gardner-Webb,-2
2021-04-27,@Winthrop,7,9,Gardner-Webb,-2
2021-04-30,@Winthrop,2,11,High Point,-9
2021-05-01,@Winthrop,11,10,High Point,1
2021-05-01,@Winthrop,15,19,High Point,-4
2021-05-05,@Winthrop,3,4,Wofford,-1
2021-05-07,@Charleston Southern,4,2,Charleston Southern,2
2021-05-08,@Charleston Southern,17,4,Charleston Southern,13
2021-05-08,@Charleston Southern,9,7,Charleston Southern,2
2021-05-11,@Campbell,3,12,Campbell,-9
2021-05-14,@Winthrop,7,16,Longwood,-9
2021-05-15,@Winthrop,7,4,Longwood,3
2021-05-15,@Winthrop,3,2,Longwood,1
2021-05-18,@Winthrop,7,6,Gardner-Webb,1
2021-05-20,@Winthrop,2,5,Presbyterian,-3
2021-05-21,@Winthrop,13,12,Presbyterian,1
2021-05-21,@Winthrop,6,7,Presbyterian,-1
2021-02-26,@Kentucky,0,10,Kentucky,-10
2021-02-27,@Kentucky,3,9,Kentucky,-6
2021-02-27,@Kentucky,2,4,Kentucky,-2
2021-03-05,@Ohio,3,14,Ohio,-11
2021-03-06,@Ohio,4,6,Ohio,-2
2021-03-06,@Ohio,1,3,Ohio,-2
2021-03-07,@Ohio,2,3,Ohio,-1
2021-03-12,@Illinois-Chicago,1,3,Illinois-Chicago,-2
2021-03-12,@Illinois-Chicago,0,1,Illinois-Chicago,-1
2021-03-13,@Illinois-Chicago,3,0,Illinois-Chicago,3
2021-03-14,@Illinois-Chicago,5,4,Illinois-Chicago,1
2021-03-19,@Northern Kentucky,3,5,Northern Kentucky,-2
2021-03-20,@Northern Kentucky,1,11,Northern Kentucky,-10
2021-03-20,@Northern Kentucky,1,4,Northern Kentucky,-3
2021-03-21,@Northern Kentucky,19,2,Northern Kentucky,17
2021-03-26,@Wisconsin-Milwaukee,6,3,IPFW,3
2021-03-27,@Wisconsin-Milwaukee,5,2,IPFW,3
2021-03-27,@Wisconsin-Milwaukee,6,5,IPFW,1
2021-03-28,@Wisconsin-Milwaukee,14,3,IPFW,11
2021-04-02,@Oakland,8,5,Oakland,3
2021-04-02,@Oakland,15,2,Oakland,13
2021-04-03,@Oakland,5,8,Oakland,-3
2021-04-03,@Oakland,14,13,Oakland,1
2021-04-09,@Wisconsin-Milwaukee,4,7,Youngstown State,-3
2021-04-09,@Wisconsin-Milwaukee,1,2,Youngstown State,-1
2021-04-10,@Wisconsin-Milwaukee,7,6,Youngstown State,1
2021-04-11,@Wisconsin-Milwaukee,12,8,Youngstown State,4
2021-04-16,@Wisconsin-Milwaukee,2,1,Illinois State,1
2021-04-17,@Wisconsin-Milwaukee,2,1,Illinois State,1
2021-04-17,@Wisconsin-Milwaukee,6,4,Illinois State,2
2021-04-18,@Wisconsin-Milwaukee,2,10,Illinois State,-8
2021-04-23,@Wisconsin-Milwaukee,1,3,Illinois-Chicago,-2
2021-04-24,@Wisconsin-Milwaukee,1,10,Illinois-Chicago,-9
2021-04-24,@Wisconsin-Milwaukee,3,10,Illinois-Chicago,-7
2021-04-25,@Wisconsin-Milwaukee,0,7,Illinois-Chicago,-7
2021-04-30,@Wisconsin-Milwaukee,2,8,Oakland,-6
2021-05-01,@Wisconsin-Milwaukee,2,5,Oakland,-3
2021-05-01,@Wisconsin-Milwaukee,21,3,Oakland,18
2021-05-02,@Wisconsin-Milwaukee,6,8,Oakland,-2
2021-05-07,@Wright State,0,2,Wright State,-2
2021-05-07,@Wright State,11,6,Wright State,5
2021-05-08,@Wright State,5,20,Wright State,-15
2021-05-08,@Wright State,2,24,Wright State,-22
2021-05-14,@Wisconsin-Milwaukee,4,9,Northern Kentucky,-5
2021-05-15,@Wisconsin-Milwaukee,1,5,Northern Kentucky,-4
2021-05-16,@Wisconsin-Milwaukee,5,4,Northern Kentucky,1
2021-05-16,@Wisconsin-Milwaukee,12,7,Northern Kentucky,5
2021-05-21,@Youngstown State,2,3,Youngstown State,-1
2021-05-22,@Youngstown State,14,12,Youngstown State,2
2021-05-22,@Youngstown State,4,9,Youngstown State,-5
2021-05-23,@Youngstown State,2,10,Youngstown State,-8
2021-05-27,@Youngstown State,9,6,Youngstown State,3
2021-05-27,@Wright State,3,4,Wright State,-1
2021-05-28,@Illinois-Chicago,14,11,Illinois-Chicago,3
2021-05-29,@Wright State,3,21,Wright State,-18
2021-02-19,@Gardner-Webb,4,5,Gardner-Webb,-1
2021-02-20,@Gardner-Webb,11,10,Gardner-Webb,1
2021-02-21,@Wofford,9,0,Gardner-Webb,9
2021-02-24,@Presbyterian,11,4,Presbyterian,7
2021-02-27,@Wofford,4,2,Xavier,2
2021-02-27,@Wofford,5,2,Xavier,3
2021-02-28,@Wofford,8,4,Xavier,4
2021-02-28,@Wofford,2,4,Xavier,-2
2021-03-02,@North Carolina-Asheville,10,9,North Carolina-Asheville,1
2021-03-05,@Jacksonville,2,8,Jacksonville,-6
2021-03-06,@Jacksonville,1,8,Jacksonville,-7
2021-03-07,@Jacksonville,2,4,Jacksonville,-2
2021-03-12,@Wofford,13,3,Toledo,10
2021-03-13,@Wofford,2,1,Toledo,1
2021-03-13,@Wofford,11,6,Toledo,5
2021-03-14,@Wofford,6,9,Toledo,-3
2021-03-19,@The Citadel,5,4,The Citadel,1
2021-03-19,@The Citadel,3,5,The Citadel,-2
2021-03-20,@The Citadel,6,0,The Citadel,6
2021-03-23,@Wofford,5,1,Davidson,4
2021-03-26,@Mercer,4,6,Mercer,-2
2021-03-27,@Mercer,12,2,Mercer,10
2021-03-27,@Mercer,7,13,Mercer,-6
2021-03-30,@Davidson,6,7,Davidson,-1
2021-04-02,@Wofford,6,5,Western Carolina,1
2021-04-03,@Wofford,12,9,Western Carolina,3
2021-04-03,@Wofford,6,11,Western Carolina,-5
2021-04-10,@East Tennessee State,3,2,East Tennessee State,1
2021-04-11,@East Tennessee State,4,7,East Tennessee State,-3
2021-04-11,@East Tennessee State,11,9,East Tennessee State,2
2021-04-13,@Wofford,7,9,South Carolina-Upstate,-2
2021-04-16,@Wofford,13,12,North Carolina-Greensboro,1
2021-04-17,@Wofford,11,10,North Carolina-Greensboro,1
2021-04-17,@Wofford,5,0,North Carolina-Greensboro,5
2021-04-21,@Wofford,12,5,College of Charleston,7
2021-04-23,@VMI,7,11,VMI,-4
2021-04-23,@VMI,7,1,VMI,6
2021-04-24,@VMI,3,2,VMI,1
2021-04-27,@Georgia State,3,4,Georgia State,-1
2021-04-30,@Wofford,8,9,Samford,-1
2021-05-01,@Wofford,7,6,Samford,1
2021-05-01,@Wofford,7,5,Samford,2
2021-05-05,@Winthrop,4,3,Winthrop,1
2021-05-07,@Wofford,11,2,The Citadel,9
2021-05-09,@Wofford,11,10,The Citadel,1
2021-05-09,@Wofford,9,0,The Citadel,9
2021-05-11,@Duke,6,9,Duke,-3
2021-05-14,@Western Carolina,13,2,Western Carolina,11
2021-05-15,@Western Carolina,20,10,Western Carolina,10
2021-05-15,@Western Carolina,4,8,Western Carolina,-4
2021-05-18,@Kennesaw State,5,4,Kennesaw State,1
2021-05-20,@Wofford,5,7,Mercer,-2
2021-05-21,@Wofford,6,0,Mercer,6
2021-05-21,@Wofford,10,3,Mercer,7
2021-05-27,@Wofford,5,16,Western Carolina,-11
2021-05-28,@Wofford,8,7,Mercer,1
2021-05-29,@Wofford,6,11,Western Carolina,-5
2021-02-22,@Vanderbilt,1,14,Vanderbilt,-13
2021-02-22,@Vanderbilt,0,1,Vanderbilt,-1
2021-02-26,@Alabama,4,8,Alabama,-4
2021-02-27,@Alabama,0,1,Alabama,-1
2021-02-27,@Alabama,7,8,Alabama,-1
2021-03-05,@Wright State,11,5,Northern Kentucky,6
2021-03-06,@Wright State,11,5,Northern Kentucky,6
2021-03-06,@Wright State,8,1,Northern Kentucky,7
2021-03-07,@Wright State,13,1,Northern Kentucky,12
2021-03-12,@Wright State,12,2,Youngstown State,10
2021-03-13,@Wright State,2,1,Youngstown State,1
2021-03-13,@Wright State,14,5,Youngstown State,9
2021-03-14,@Wright State,6,1,Youngstown State,5
2021-03-19,@Illinois-Chicago,7,5,Illinois-Chicago,2
2021-03-20,@Illinois-Chicago,12,4,Illinois-Chicago,8
2021-03-20,@Illinois-Chicago,7,0,Illinois-Chicago,7
2021-03-21,@Illinois-Chicago,12,5,Illinois-Chicago,7
2021-03-26,@Youngstown State,10,12,Youngstown State,-2
2021-03-27,@Youngstown State,20,8,Youngstown State,12
2021-03-27,@Youngstown State,0,4,Youngstown State,-4
2021-03-28,@Youngstown State,10,11,Youngstown State,-1
2021-04-16,@Florida Gulf Coast,12,13,Florida Gulf Coast,-1
2021-04-16,@Wright State,10,3,Florida Gulf Coast,7
2021-04-17,@Florida Gulf Coast,4,6,Florida Gulf Coast,-2
2021-04-23,@Northern Kentucky,12,1,Northern Kentucky,11
2021-04-23,@Northern Kentucky,8,6,Northern Kentucky,2
2021-04-25,@Northern Kentucky,11,6,Northern Kentucky,5
2021-04-25,@Northern Kentucky,12,2,Northern Kentucky,10
2021-04-30,@IPFW,9,1,IPFW,8
2021-05-01,@IPFW,28,7,IPFW,21
2021-05-01,@IPFW,22,2,IPFW,20
2021-05-02,@IPFW,29,6,IPFW,23
2021-05-07,@Wright State,2,0,Wisconsin-Milwaukee,2
2021-05-07,@Wright State,6,11,Wisconsin-Milwaukee,-5
2021-05-08,@Wright State,20,5,Wisconsin-Milwaukee,15
2021-05-08,@Wright State,24,2,Wisconsin-Milwaukee,22
2021-05-14,@Wright State,7,4,Oakland,3
2021-05-14,@Wright State,16,0,Oakland,16
2021-05-15,@Wright State,8,7,Oakland,1
2021-05-15,@Wright State,14,6,Oakland,8
2021-05-21,@Wright State,6,2,Charleston (WV),4
2021-05-22,@Wright State,9,2,Charleston (WV),7
2021-05-23,@Wright State,12,3,Charleston (WV),9
2021-05-27,@Wright State,4,3,Wisconsin-Milwaukee,1
2021-05-28,@Wright State,15,4,Illinois-Chicago,11
2021-05-29,@Wright State,21,3,Wisconsin-Milwaukee,18
2021-06-04,@Tennessee,8,9,Tennessee,-1
2021-06-05,@Wright State,6,14,Duke,-8
2021-02-20,@Texas A&M,10,6,Texas A&M,4
2021-02-20,@Texas A&M,2,0,Texas A&M,2
2021-02-21,@Texas A&M,0,15,Texas A&M,-15
2021-02-27,@Wofford,2,5,Wofford,-3
2021-02-27,@Wofford,2,4,Wofford,-2
2021-02-28,@Wofford,4,2,Wofford,2
2021-02-28,@Wofford,4,8,Wofford,-4
2021-03-12,@Baylor,3,7,Baylor,-4
2021-03-13,@Baylor,4,11,Baylor,-7
2021-03-14,@Baylor,0,10,Baylor,-10
2021-03-19,@Cincinnati,2,1,Cincinnati,1
2021-03-20,@Xavier,7,22,Cincinnati,-15
2021-03-21,@Xavier,16,8,Cincinnati,8
2021-03-22,@Cincinnati,2,7,Cincinnati,-5
2021-03-26,@Evansville,6,1,Evansville,5
2021-03-27,@Evansville,0,1,Evansville,-1
2021-03-27,@Evansville,4,7,Evansville,-3
2021-03-28,@Evansville,2,9,Evansville,-7
2021-04-02,@Xavier,5,1,Dayton,4
2021-04-02,@Xavier,1,4,Dayton,-3
2021-04-03,@Dayton,24,16,Dayton,8
2021-04-03,@Dayton,14,11,Dayton,3
2021-04-09,@St. John's,1,2,St. John's,-1
2021-04-10,@St. John's,12,3,St. John's,9
2021-04-11,@St. John's,18,6,St. John's,12
2021-04-16,@Xavier,9,2,Butler,7
2021-04-17,@Xavier,3,7,Butler,-4
2021-04-17,@Xavier,7,2,Butler,5
2021-04-18,@Xavier,16,6,Butler,10
2021-04-25,@Xavier,5,0,Connecticut,5
2021-04-25,@Xavier,5,8,Connecticut,-3
2021-04-27,@Xavier,13,15,Connecticut,-2
2021-04-27,@Xavier,6,5,Connecticut,1
2021-04-30,@Villanova,1,2,Villanova,-1
2021-05-01,@Villanova,1,0,Villanova,1
2021-05-02,@Villanova,5,12,Villanova,-7
2021-05-07,@Xavier,1,4,Seton Hall,-3
2021-05-07,@Xavier,6,1,Seton Hall,5
2021-05-08,@Xavier,2,7,Seton Hall,-5
2021-05-08,@Xavier,7,6,Seton Hall,1
2021-05-14,@Xavier,9,0,Georgetown,9
2021-05-14,@Xavier,2,0,Georgetown,2
2021-05-15,@Xavier,1,5,Georgetown,-4
2021-05-16,@Xavier,10,0,Georgetown,10
2021-05-16,@Xavier,2,1,Georgetown,1
2021-05-20,@Creighton,10,5,Creighton,5
2021-05-21,@Creighton,2,3,Creighton,-1
2021-05-21,@Creighton,6,2,Creighton,4
2021-05-22,@Creighton,2,3,Creighton,-1
2021-05-27,@Connecticut,1,11,Connecticut,-10
2021-05-28,@Seton Hall,4,2,Seton Hall,2
2021-05-29,@Creighton,2,1,Creighton,1
2021-05-30,@Connecticut,5,4,Connecticut,1
2021-05-30,@Connecticut,6,10,Connecticut,-4
2021-02-19,@Troy,4,10,Troy,-6
2021-02-20,@Troy,2,8,Troy,-6
2021-02-20,@Troy,6,13,Troy,-7
2021-02-21,@Troy,4,2,Troy,2
2021-02-26,@Nicholls State,6,7,Nicholls State,-1
2021-02-26,@Louisiana State,2,6,Louisiana State,-4
2021-02-27,@Louisiana State,3,5,Louisiana State,-2
2021-02-28,@Nicholls State,7,4,Nicholls State,3
2021-03-05,@IPFW,6,3,IPFW,3
2021-03-06,@IPFW,3,0,IPFW,3
2021-03-07,@IPFW,0,1,IPFW,-1
2021-03-07,@IPFW,13,8,IPFW,5
2021-03-12,@Wright State,2,12,Wright State,-10
2021-03-13,@Wright State,5,14,Wright State,-9
2021-03-13,@Wright State,1,2,Wright State,-1
2021-03-14,@Wright State,1,6,Wright State,-5
2021-03-20,@Youngstown State,7,1,St. Bonaventure,6
2021-03-20,@Youngstown State,6,4,St. Bonaventure,2
2021-03-21,@Youngstown State,22,6,St. Bonaventure,16
2021-03-26,@Youngstown State,12,10,Wright State,2
2021-03-27,@Youngstown State,4,0,Wright State,4
2021-03-27,@Youngstown State,8,20,Wright State,-12
2021-03-28,@Youngstown State,11,10,Wright State,1
2021-04-02,@Youngstown State,0,6,Illinois-Chicago,-6
2021-04-02,@Youngstown State,2,1,Illinois-Chicago,1
2021-04-03,@Youngstown State,14,9,Illinois-Chicago,5
2021-04-03,@Youngstown State,13,9,Illinois-Chicago,4
2021-04-09,@Wisconsin-Milwaukee,2,1,Wisconsin-Milwaukee,1
2021-04-09,@Wisconsin-Milwaukee,7,4,Wisconsin-Milwaukee,3
2021-04-10,@Wisconsin-Milwaukee,6,7,Wisconsin-Milwaukee,-1
2021-04-11,@Wisconsin-Milwaukee,8,12,Wisconsin-Milwaukee,-4
2021-04-16,@Northern Kentucky,7,9,Northern Kentucky,-2
2021-04-17,@Northern Kentucky,1,0,Northern Kentucky,1
2021-04-17,@Northern Kentucky,2,7,Northern Kentucky,-5
2021-04-18,@Northern Kentucky,18,6,Northern Kentucky,12
2021-04-23,@Youngstown State,4,3,Oakland,1
2021-04-23,@Youngstown State,12,6,Oakland,6
2021-04-24,@Youngstown State,4,3,Oakland,1
2021-04-25,@Youngstown State,18,6,Oakland,12
2021-04-30,@Illinois-Chicago,1,0,Illinois-Chicago,1
2021-05-01,@Illinois-Chicago,1,3,Illinois-Chicago,-2
2021-05-01,@Illinois-Chicago,7,8,Illinois-Chicago,-1
2021-05-02,@Illinois-Chicago,7,18,Illinois-Chicago,-11
2021-05-07,@Youngstown State,6,2,IPFW,4
2021-05-07,@Youngstown State,15,4,IPFW,11
2021-05-08,@Youngstown State,1,3,IPFW,-2
2021-05-08,@Youngstown State,7,5,IPFW,2
2021-05-14,@Bellarmine,11,3,Bellarmine,8
2021-05-15,@Bellarmine,11,6,Bellarmine,5
2021-05-16,@Bellarmine,5,1,Bellarmine,4
2021-05-21,@Youngstown State,3,2,Wisconsin-Milwaukee,1
2021-05-22,@Youngstown State,9,4,Wisconsin-Milwaukee,5
2021-05-22,@Youngstown State,12,14,Wisconsin-Milwaukee,-2
2021-05-23,@Youngstown State,10,2,Wisconsin-Milwaukee,8
2021-05-27,@Illinois-Chicago,4,7,Illinois-Chicago,-3
2021-05-27,@Youngstown State,6,9,Wisconsin-Milwaukee,-3
